We perform burial transport in the country and international .	Wir machen bestattungs transport im innland und ausland .
This causes real problems for those organisations .	Das verursachte diesen Organisationen echte Probleme .
We look forward to seeing you !	Testen Sie uns ! Wir freuen uns auf Sie !
In that respect we have decided correctly .	Wir haben insofern richtig entschieden .
The President cut the speaker off	Der Präsident entzieht dem Redner das Wort .
Surely not !	Einer der Aspekte ist der , was das Ganze kostet .
Are there any comments ?	Gibt es Einwände ?
The happiness of the earth … lies on the back of a horse .	Das Glück der Erde … liegt auf dem Rücken der Pferde .
The vote will take place on Thursday at 12 noon .	Die Abstimmung findet am Donnerstag ab 12.00 Uhr statt .
How do we use the information that we receive from you ?	Wie verwenden wir von Ihnen erhaltene Daten ?
The last from 3 stops is in front of VIP room .	Der letzte von drei Stops ist vor einem VIP Raum .
We &apos;ve almost run out of November in Australia and New Zealand !	Or at least it will in a few hours !
I just love watching people having sex .	Mir gefällt es einfach nur , wenn ich sehe , wie zwei Menschen Sex haben .
Maybe that ’ s really how it is .	Vielleicht ist das wirklich so .
Applause	Beifall
This is necessary and important .	Dies ist notwendig und wichtig .
The debate is closed .	Die Aussprache ist geschlossen .
Do you need max of each ?	Braucht man die maximale Anzahl von jedem ?
Leisure : Faunia , Zoo Acuarium de Madrid , Imax Madrid ...	Freizeit : Faunia , Zoo Acuarium de Madrid , Imax Madrid ...
Recommendations for application are without guarantee .	Die Angaben der Anwendungsberatung sind unverbindlich .
Your room at Suvretta House is your refuge .	Ihr Zimmer im Suvretta House ist Ihr Refugium .
Tadese has never heard of global warming .	Tadese hat noch nie von globaler Erwärmung gehört .
We therefore need innovation in two areas .	Wir brauchen Innovation in zwei Bereichen .
They must become European .	Sie müssen Europäer werden .
There is still room for improvement in this respect .	Hier muss noch nachgebessert werden .
A number of proposals have been put forward .	Dazu wurde eine Reihe von Vorschlägen unterbreitet .
forums about Marseille - Bouches du Rhone .	Foren über Marseille - Bouches du Rhone .
The disease takes an intermittent , chronic course .	Die Erkrankung verläuft chronisch und intermittierend .
Female Body of God flowering horse ...	Kürzlich gelegentlich möchte Karten ziehen , werden ein gutes Zeichen ist .
( The President cut the speaker off )	( Der Präsident entzieht dem Redner das Wort . )
Topical and urgent debate ( objections )	Dringlichkeitsdebatte ( Einsprüche )
We must not let this happen again .	Wir dürfen das nicht noch einmal zulassen .
Yet , I would still like to make a few observations .	Aber dennoch möchte ich einige Anmerkungen dazu machen .
How do we say &apos; against &apos; ?	Was sagen wir für &quot; dagegen &quot; ?
I would just like to underline one thing .	Ich möchte nur einen Punkt hervorheben .
Domus Inn · Via Velletri 10 , 00186 Rome Italy · Ph.	Domus Inn · Via Velletri 10 , 00186 Rom Italien · Tel .
Contributions of all sizes are greatly appreciated .	Spenden werden in jeglicher Höhe sind äußerst willkommen .
Deregulation led to fierce competition for market share .	Die Deregulierung führte zu harten Kämpfen um Marktpositionen .
It has a vast lobby and reception area .	Es hat eine sehr große Empfangshalle .
also pudes going to drink ...	abends auch einen Drink zu ...
Adjournment of the session	Unterbrechung der Sitzungsperiode
Your name is required .	Your name is required .
Sometimes it ’ s just not convenient to talk .	Manchmal ist ein Gespräch einfach nicht praktikabel .
Ceaseless and clean power supply for your equipment .	Unterbrechungsfreie und saubere Energiezufuhr zu Ihren Geräten .
Her father is an architect in Laguna Beach , California .	Ihr Vater ist Architekt in Laguna Beach , California .
How often do I check my email ?	Wie oft lese ich meine email ?
The effects are dedramatized and minimized .	Die Effekte werden heruntergespielt und bagatellisiert .
Aren &apos;t the Germans afraid of their past ?	Fürchten sich die Deutschen nicht vor der Vergangenheit ?
How to improve spiritually and personally ?	Wie verbessert man die geistig und persönlich ?
Even with the rims of 17 ?	Auch bei den Felgen von 17 ?
This information must come from incorrect sources .	Ihre Informationen müssen aus fehlerhaften Quellen stammen .
The worrying level of insecurity there concerns us all .	Die Besorgnis erregend hohe Unsicherheit betrifft uns alle .
In short , it wants to liberalise .	Kurzum , es geht um Liberalisierung .
Is it possible to take a shower after the race ?	Kann man sich nach dem Lauf irgendwo duschen ?
Subject : MAGP IV : Beam trawler length	Betrifft : MAP IV : Baumkurrenlänge
The hotel operates the catering service .	Unseres Hotel Hotel hilf Ihn bei jeder art von Organisationen .
There are a number of relevant examples .	Dafür können wir zahlreiche Beispiele nennen .
Declined : The player has declined the event invitation .	Abgelehnt : Der Spieler hat die Einladung abgelehnt .
There was deadlock .	Dadurch gerieten die Verhandlungen in eine Sackgasse .
This is the crux of the matter .	Dies ist der springende Punkt .
Thank you for your comments , Mr Moraes .	Vielen Dank für Ihre Anmerkungen , Herr Moraes .
These figures come from your services .	Dies sind Zahlen von Ihren Diensten .
I would finally like to express a few considerations .	Schließlich möchte ich einige wenige Überlegungen anstellen .
( Applause from the left and protests from the right )	( Beifall von links und Proteste von rechts )
The kitchen is open daily from 12 : 00 to 21 : 30 .	Die Küche ist täglich von 12 : 00 bis 21 : 30 geöffnet .
It is not a model , but a prototype .	Es ist kein Modell , sondern ein Unikat .
Ask other businessmen to this topic .	Ein Unternehmen wird immer durch eine Idee entstehen .
Select How did you hear about us ?	Select Wo haben Sie von uns gehört ?
We demand equality - neither more , nor less .	Wir fordern Gleichbehandlung - nicht mehr und nicht weniger .
Muy recomendable para pasar unos dias romanticos .	even a birthday cake and present as a suprise .
I think we should take a more positive approach here .	Ich denke , wir sollten positiver an diese Sache herangehen .
0 votes &#124; 0 views &#124; 0 com .	0 votes &#124; 871 views &#124; 0 com .
They can no longer communicate in confidence .	Eine unbefangene Kommunikation ist nicht mehr möglich .
What does she like most about Europa Casino ?	Was Sie am Europa Casino am besten findet ?
Place of defense : FACULTAD DE CIENCIAS.AUTONOMA DE MADRID .	Ort der Lesung : FACULTAD DE CIENCIAS.AUTONOMA DE MADRID .
We do not think this is the right way to proceed .	Wir halten das nicht für den richtigen Weg .
Written statements ( Rule 149 )	Schriftliche Erklärung ( Artikel 149 )
is used to encode the aspect ratio of the file .	wird zum Encodieren des Seitenverhältnisses einer Datei verwendet .
I know this from my own experience .	Dies weiß ich aus eigener Erfahrung .
Parliament has now completed its agenda .	Das Parlament hat die Tagesordnung erschöpft .
What should women know before taking antibiotics ?	Was sollten Frauen vor der Einnahme von Antibiotika beachten ?
When would you like to stay at the Villa Antea Apartments ?	Wann möchten Sie im Villa Antea Apartments übernachten ?
I therefore explained the sequence of events .	Aber auf jeden Fall habe ich Ihnen den Hergang erläutert .
What we need today is economic governance .	Was wir heute brauchen , ist eine wirtschaftliche Regierungsführung .
There are four parts trees , plus tree of transparency .	Es gibt vier Teile Bäume , Baum plus Transparenz .
The vote will take place on Tuesday at 12 noon .	Die Abstimmung findet am Dienstag um 12.00 Uhr statt .
The vote will take place tomorrow at 11 a.m.	Die Abstimmung findet morgen um 11.00 Uhr statt .
The system includes a JCL preprocessor .	Der Parser enthält einen JCL Präprozessor .
Protein is essential for healthy animal nutrition .	Eiweiß ist für die gesunde Tierernährung unbedingt notwendig .
Контора продает уборочное оборудование - уборочное оборудование гигиена .	Школа ремонта своими руками - ремонт nokia .
The inner side displays lilac epoxy .	Die Innenseite der Flügel hebt lilafarbenes Epoxy hervor .
No Hotels found with your criteria .	Keine Hotels mit den passenden Kriterien gefunden .
We can learn from each other .	Das geschah leider auch im negativen Sinn .
That would be regaining the initiative .	Damit würden wir die Initiative wieder übernehmen .
What is behind all this ?	Warum ist das so ?
Because what does the Commission do ?	Was tut nämlich die Kommission ?
EC ##AT##-##AT## Gabon Fisheries Partnership ( debate )	Fischereiabkommen EG / Gabun ( Aussprache )
There are many points there .	Da gibt es viele Punkte .
( DE ) Mr President , human rights are indivisible .	Herr Präsident ! Menschenrechte sind unteilbar .
Next , democracy means transparency .	Demokratie bedeutet schließlich Transparenz .
I fear they watch for us .	Ich befürchte , sie interessieren sich für uns .
Do they want a politically integrated EU ?	Möchten sie eine politisch integrierte EU ?
Cultivation of peas is now in decline , however .	Der Anbau von Erbsen nimmt jetzt jedoch ab .
Or how about a little more speed ?	Oder darf es mehr Speed sein ?
This seems to be unacceptable to me .	Das halte ich für inakzeptabel .
Another example is a jazz jam session .	Ein weiteres Beispiel ist eine Jam Session beim Jazz .
Madam President , I very much welcome this initiative .	Frau Präsidentin , ich begrüße diese Initiative sehr .
We must now consider ICT as a resource .	Wir müssen jetzt die IKT als Ressource betrachten .
Stay clean and have a nice weekend !	Haltet die Ohren steif und genießt das super Wetter !
It undoubtedly depends on two major advances .	Sie hängt ganz sicher von zwei Grundvoraussetzungen ab .
This also makes sound environmental sense .	Das rechnet sich auch für die Umwelt .
End of quote .	Ende des Zitats .
VOTE	ABSTIMMUNGEN
MODEL : HDS722580VLSA80 — this is the disk model .	MODEL : HDS722580VLSA80 — das ist das Modell der Platte .
The debate is closed .	Die Aussprache ist geschlossen .
People do not live on money alone .	Der Mensch lebt nicht nur von Geld allein .
The nearest airports are Treviso and Venice .	Die nächsten Flughäfen sind Treviso und Venedig .
The furnishings impart comfortable elegance and style .	Die Einrichtung vermittelt behagliche Eleganz und Stil .
The euro is the EU ’ s single currency .	Der Euro ist die einheitliche Währung der Europäischen Union .
I therefore voted in favour .	Aus diesem Grund habe ich dafür gestimmt .
Die Lage des Hotels war gut .	удобное расположение в центре города непосредственно около источников .
Thank you .	Vielen Dank .
Welcome · Identity - What do I identify with ?	Willkommen · Identität - Womit identifi ziere ich mich ?
With male patients , ok , but what about the girls ?	Beim Mann ja OK , aber bei Frauen ?
The debate is closed .	Die Aussprache ist geschlossen .
We need more in the way of Europe .	Wir brauchen mehr Europa .
Later I was told the dog is dying and reportedly he died on Saturday .	Später erfuhr ich aber , dass er stirbt .
Yet , the rapporteur carefully avoids this question .	Doch der Berichterstatter umgeht vorsichtigerweise diese Frage .
The debate is closed .	Die Aussprache ist geschlossen .
Oxygen levels are very low .	Der Sauerstoffgehalt ist ausgesprochen gering .
Peel and cut the carrots into thin slices 1 mm thick .	Die Möhren schälen und in 1 mm dicke Rondelle schneiden .
Firstly , the free movement of workers .	Das erste Beispiel ist die Freizügigkeit der Arbeitnehmer .
Decoupling is also a complicated area .	Zur Entkoppelung : Das ist auch kein einfaches Feld .
1 vote &#124; 24 views &#124; 0 com .	1 vote &#124; 400 views &#124; 0 com .
He has dealt with hundreds of comments .	Er ist auf Hunderte von Kommentaren eingegangen .
The reality is , however , rather different .	Die Realität sieht jedoch völlig anders aus .
The capital Nouakchott has 1 million inhabitants .	Die Hauptstadt Nouakchott hat 1 Million Einwohner .
You can get surprising results and learn a lot .	Wie viele Menschen rauchen tatsächlich in Restaurants ?
Why can we not do the same ?	Weshalb können wir nicht eine ähnliche Einrichtung schaffen ?
Book the best hostels in Haikou with Hostelsclub .	Bucht die besten Hostels in Haikou über Hostelsclub .
Book the best hostels in Nuremberg with Hostelsclub .	Bucht die besten Hostels in Nürnberg über Hostelsclub .
This is exactly what we are trying to do .	Genau dies ist unser Bestreben .
There is always something on in Oslo !	In Oslo gibt es immer etwas zu sehen !
It is a pity that only now I remembered about it ...	Es ist schade , dass erst jetzt erinnerte ich daran ...
Mr President , Commissioner , ladies and gentlemen .	( SV ) Herr Präsident , Frau Kommissarin ! Liebe Kollegen !
We have negotiated with all the groups .	Wir haben mit allen Fraktionen verhandelt .
I will mention three of these .	Ich werde drei davon erwähnen .
In need you learn HTML or PHP !	In der Notwendigkeit erlernen Sie HTML oder PHP !
How can we achieve this objective ?	Wie können wir dieses Ziel erreichen ?
They can have silver or yellow colour .	Sie können die silberne und die gelbe Farbe haben .
Experience the ease of use and the stunning results !	Wir empfehlen : Machen Sie sich selbst ein Bild davon !
I trained her from time to time and had a few runs at trials with her .	Sadie versucht immer alles richtig zu machen .
Yet another Rambouillet ?	Wegen Rambouillet 45 ?
This shows how the work of the media is bearing fruit .	Das zeigt , wie die Arbeit der Medien Früchte trägt .
You spoke of speculation , Mr Obermayr .	Sie haben von Spekulationen gesprochen , Herr Obermayr .
This also applies to all adjustment transactions .	Fehlender Widerspruch bedeutet in keinem Falle unsere Zustimmung .
But what , if anything , should be done differently ?	Doch was sollte , wenn überhaupt , anders gemacht werden ?
Situated about m 250 from the beach .	250 m vom Strand von Riomar entfernt .
Why am I worried ?	Warum ich darüber besorgt bin ?
That is the spirit emanating from this report .	Dies ist der Geist , den der vorliegende Bericht atmet .
You would describe it as outreach work .	Sie , Herr Kommissar , würden das als Öffentlichkeitsarbeit beschreiben .
##STAR## Please fill out this fields completely .	##STAR## Wir bitten Sie , diese Felder vollständig auszufüllen .
weight 10 kg , Ø 316 mm , height 50 mm .	Gewicht 10 kg , Ø 316 mm , Höhe 50 mm .
In that case , there will be no peace .	In diesem Falle wird es keinen Frieden geben .
Rooms come with LCD TV and Wi ##AT##-##AT## Fi access .	Die Türme von Bologna finden Sie in unmittelbarer Nähe .
I have three further comments .	Ich möchte noch drei weitere Bemerkungen vorbringen .
Finally we reach the summit on the third day .	Am dritten Tag werden wir wie vorne beschrieben den Gipfel erreichen .
At least 2 ##AT##-##AT## 3 weeks have to elapse for a painless walk .	Nach 2 -3 Woche werden Sie keine Schmerzen haben .
Subject : Energy cooperation in south ##AT##-##AT## east Europe	Betrifft : Energiezusammenarbeit in Südosteuropa
The transport sector is a typical example .	Der Transportsektor ist ein typisches Beispiel dafür .
You can follow responses through the Comments Feed .	Sie können Antworten durch den Kommentar ##AT##-##AT## Feed .
We have seen a lot of smiling faces !	Wir haben eine Menge laechelnder Gesichter gesehen .
We are not starting with nothing .	Wir beginnen ja nicht bei Null .
Which time zones apply to Australia ?	Welche Zeitverschiebung gibt es nach Australien ?
Sulfur Vent enters the battlefield tapped .	Der Schwefelkrater kommt getappt ins Spiel .
You will reach the town in about 25 minutes .	Sie erreichen das Dorf in ca. 25 min .
You have selected a property under % dummy % .	Sie haben ein Hotel unter % dummy % .
This has to be put right !	Hier hat Ordnung einzuziehen !
Mr President , an Internet Charter makes very good sense .	Herr Präsident !
Last year he was wanted for murder .	Letztes Jahr wurde er wegen Mordes gesucht .
The issue is : who should decide ?	Die Frage ist , wer soll entscheiden ?
Time will tell .	Das wird sich mit der Zeit zeigen .
New ! Лондон , Южная Англия , Панорама Уэльса на 11 дней .	Западная Германия на 10 / 13 дней .
( Applause )	( Beifall )
The vote will take place on Wednesday at 12 noon .	Die Abstimmung findet am Mittwoch um 12.00 Uhr statt .
Ministry for Economy and Work of the County NRW .	Ministerium für Wirtschaft und Arbeite des Landes NRW .
So what needs to happen ?	Was muß also geschehen ?
How amazing can this game even get !	bangy 78 sauf que dans Forza t &apos; as pas de stands !
We have over 150 Britain products in our online shop .	In unserem Shop führen wir über 150 britische Produkte .
Who is going to be the most happy owner ?	Vielleicht sind Sie bald der glückliche Besitzer ?
Ibiza is the perfect place for families to come and visit .	Ibiza ist wie geschaffen für einen runden Familienurlaub .
We shall have to look into this matter , however .	Wir werden uns aber mit dieser Frage beschäftigen müssen .
Is it safe to buy from E ##AT##-##AT## bestseller ?	Is it safe to buy from Chinavasion ?
What are we doing to natural cost structures ?	Was macht man mit der natürlichen Kostenstruktur ?
I cannot fully grasp the underlying rationale .	Ich verstehe die Zusammenhänge nicht ganz .
You may count on us - your partner - worldwide .	Rechnen Sie mit uns - Ihrem Partner - weltweit .
This will make their use transparent for you .	So wird der Gebrauch für Sie transparent .
A mistake has been made .	Da ist ein Irrtum passiert .
I have a question for the Council .	Ich habe eine Frage an den Rat .
That is why I am here this morning .	Aus diesem Grund bin ich heute Morgen hier .
Clearly , alternative solutions are needed .	Es müssen unbedingt Alternativlösungen gefunden werden .
Both are there - freedom from fear and freedom from want .	Es zählt beides - Freiheit von Furcht und Freiheit von Not .
It needs more imagination and more innovation .	Wir benötigen mehr Vorstellungskraft und Innovation .
Have fun and maybe we will see there !	Viel Spaß und vielleicht bis dann !
Of course it is all good political banter in a way .	Natürlich ist das hier alles nur eine Art politisches Geplänkel .
It was also the central theme of today &apos; s debate .	Er spielte ja auch in der Debatte heute mit die größte Rolle .
The debate is closed .	Die Aussprache ist geschlossen .
Here you see the snapshots of the last 40 minutes .	Hier sehen Sie die Aufnahmen der letzten 40 Minuten .
The debate is closed .	Die Aussprache ist geschlossen .
Thank you .	Vielen Dank .
You approve secrecy instead of transparency .	Sie nehmen Geheimhaltung anstelle von Transparenz in Kauf .
from 24 hours up to 1 hour prior to departure .	Ab 24 Stunden bis 1 Stunde vor Abflug .
We do not want China to crumble .	Wir wollen nicht , dass China zerfällt .
The beds are made up when you arrive .	Die Betten sind bei Ankunft fertig gemacht .
What if we look at cost of acquiring a job ?	Was passiert , wenn wir uns mit Kosten für den Erwerb einen Job ?
Secondly , the budget must be forward ##AT##-##AT## looking .	Zweitens muss der Haushaltsplan zukunftsorientiert sein .
Before we got detectors we used iron rods .	Bevor wir Detektoren hatten , benutzten wir Eisenstangen .
I have one thing to say to you .	Ich habe Ihnen dazu noch eine Sache zu sagen .
Paid accounts are never removed automatically .	Zu bezahlende Konten werden niemals automatisch gelöscht .
Nevertheless they will work without any problem ) .	Unbeachtet dieser Problematik laufen beide Programme ohne Problem .
35 new Pics , Platform Pumps and Platform Sandals .	35 neue Bilder , im Ordner Plateaupumps und Plateausandaletten .
Hotel Paulin salutes warmly its guests .	Hotel Paulin begrüßt warm seine Gäste .
&gt; &gt; How do I place a bet ?	&gt; &gt; Wie schliesse ich eine Wette ab ?
The solemn inauguration took place on the 2nd October 1898 .	Die Feierliche Einweihung erfolgte am 2. Oktober 1898 .
How many people are in the group ?	Wieviele Leute sind in einer Gruppe ?
Your message has been sent correctly .	Ihre Botschaft richtig geschickt werden hat .
Based on work by Brian Jones and Iain Cameron .	Based on work by Brian Jones und Iain Cameron .
Nothing juicy , nothing of note , just fond memories and some kind ...	Je länger sie sich dabei gegen die ...
( The oral amendment was accepted )	( Der mündliche Änderungsantrag wird angenommen . )
What is that development to look like ?	Wie sieht die weitere Entwicklung aus ?
It fell .	Der Turm stürzte ein .
I believe this procedure is wrong .	Ich finde , so kann man nicht verfahren .
The fight against fraud must be a priority for us .	Gerade die Betrugsbekämpfung muß für uns Vorrang haben .
In our experience , the framework agreement operates well .	Dieses Rahmenabkommen funktioniert unserer Ansicht nach gut .
Everyone knows that .	Das weiß doch jeder .
The debate is closed .	Die Aussprache ist geschlossen .
In this event a medical certificate will have to be submitted .	In diesem Fall ist ein ärztliches Attest vorzulegen .
1 vote &#124; 710 views &#124; 0 com .	0 votes &#124; 491 views &#124; 0 com .
Recylex is listed in compartment B of Euronext Paris .	Recylex ist an der Euronext Paris , Compartment B notiert .
You learn how to harness and put the dogs onto the lead .	Lernen Sie die Hunde einzuschirren und einzuspannen .
Mistrust , rather than trust , has typified relations .	Sie wurden eher von Misstrauen als von Vertrauen geprägt .
Good food quality and decent prices .	Die Stadt , die Taormina zu Füßen liegt , besitzt viele Clubs und Discotheken .
Sales Talk Tamabi not be cultivated in the organization .	Sales Talk Tamabi nicht in der Organisation gepflegt werden .
It all went wrong in Copenhagen .	Es ist schiefgegangen in Kopenhagen .
That means that we have got it right .	Das heißt , dass wir alles richtig gemacht haben .
It is a pro ##AT##-##AT## market approach and it should work .	Dieser marktfreundliche Ansatz sollte funktionieren .
It helps the organism to help itself .	Es hilft dem Organismus dabei , sich selbst zu helfen .
Novo Belenguer report ( A4 ##AT##-##AT## 0210 / 97 )	Bericht Novo Belenguer ( A4 ##AT##-##AT## 0210 / 97 )
( The President cut off the speaker )	( Der Präsident entzieht dem Redner das Wort . )
That is what I should like to say by way of introduction .	Dies wollte ich gern einleitend zum Ausdruck bringen .
An example of such wines is the winery Bodega Los Barrancos .	Eines dieser Beispiele ist die Bodega Los Barrancos .
The Union cannot overlook any course of action .	Die Union darf keinen Handlungsansatz unberücksichtigt lassen .
This has caused unfair competition for many years .	Dadurch herrscht schon jahrelang unlauterer Wettbewerb .
When would you like to stay at the Grecian Bay ?	Wann möchten Sie im Grecian Bay übernachten ?
Thank you , Commissioner .	– Vielen Dank , Herr Kommissar .
Thank you , Commissioner de Palacio .	Danke , Frau De Palacio .
You are not the President of Parliament yet !	Noch sind Sie nicht Präsident des Parlaments !
We personally deliver the collectors to our customers .	Wir liefern unsere Kollektoren persönlich beim Kunden ab .
One week Al Inclusive super discounted ! ! !	EINE WOCHE ALL INCLUSIVE + FLUG + TRANSFERT MIT SUPER RABATT !
Composition of Parliament : see Minutes	Zusammensetzung des Parlaments : siehe Protokoll
No quick fix exists for oil prices .	Für die Ölpreise gibt es keine schnelle Lösung .
On May 24 Protuts entered in the history of blogging !	Sie Probleme mit der Ausführung von Microsoft Outlook ?
Yet the international pressure is muted .	Doch das Drängen auf internationaler Ebene ist verstummt .
Is that correct ?	Ist das richtig ?
There is no other way .	Anders geht es nicht .
This is what the US experiment shows , in any case .	Das zeigt jedenfalls das US ##AT##-##AT## amerikanische Experiment .
We in Parliament need to reflect on that too .	Wir als Parlament sollten darüber nachdenken .
The views expressed by Herr Schulz meet the case .	Die von Herrn Schulz geäußerten Ansichten , treffen zu .
In fact , the date was 19 July .	Er starb jedoch in Wirklichkeit am 19. Juli .
For that to exist there has to be a nation .	Damit es eine Macht des Volkes gibt , muß es ein Volk geben .
Guys - now we had enough cinema !	Jungs , nun reichts aber mit eurer Kinovorstellung !
I would therefore like to urge you to vote in favour of Amendment No 81 .	Insofern möchte ich für den Antrag 81 werben .
MiniCard holders are available in a new range of colours !	MiniCard ##AT##-##AT## Etuis gibt es jetzt in neuen Farben !
It was not altogether clear .	Das war nicht ganz klar .
I want to receive announcements about minor product releases .	Ich möchte über Updates informiert werden .
Sets the value of the specified directive .	Setzt den Wert der angegebenen Direktive .
The answer is yes .	Die Antwort ist Ja .
( Parliament adopted the legislative resolution )	( Das Parlament nimmt den Entwurf der legislativen Entschließung an . )
- Is &quot; to travel to possess the world &quot; ?	- Bedeutet zu reisen &apos; die Welt zu besitzen &apos; ?
This work formed the object of three texts .	Diese Arbeit bildet den Gegenstand dreier Texte .
The debate is closed .	Die Aussprache ist geschlossen .
That means in every season enjoy .	Das heißt , in jeder Jahreszeit zu genießen .
It is ours . &quot;	Eine Staatswerdung liegt bei den Einwohnern , bei uns . ”
Renationalisation is also a tool we can work with .	Es sollte auch eine Renationalisierung angestrebt werden .
The vedalken always put their best thought forward .	Die Vedalken lassen gerne ihre besten Gedanken für sich arbeiten .
It is really he who is responsible for this whole affair .	Schuld an dieser ganzen Geschichte war schließlich er selbst .
I ask you : less federalist than what ?	Ich frage Sie : weniger föderalistisch als was ?
All inclusive service except for alcoholic drinks .	Bademantel und Saunakorb auf dem Zimmer !
A rental car costs approximately 40 dollars per day .	Mietwagen kosten ca. 40 Dollar pro Tag .
Using RSS is as easy as surfing the Net .	Und die Verwendung von RSS ist so einfach wie das Surfen im Internet .
You can change the setting of the locking system .	Sie können die Einstellung des Schließsystems ändern .
Race your way to fame and fortune !	Auf der Rennstrecke zu Ruhm und Glück !
Rules must be enacted to prevent such a thing .	Es muss geregelt werden , dass das nicht passieren kann .
We must therefore take a tough line with Iran .	Wir müssen deshalb beim Iran eine harte Linie verfolgen .
Are there any other comments ?	Gibt es Einwände ?
Thank you , Mr President , for the very precise answer .	Danke , Herr Präsident , für die sehr präzise Antwort .
» Rumour : NFS Hot Pursuit Remake &amp; NFS Shift 2 ?	» Gerücht : NFS Hot Pursuit Remake &amp; NFS Shift 2 ?
Howie hits his head against Paiste cymbals ...	Howie &apos; s Stirn küsst am liebsten Paiste Cymbals ...
Your 2 choices are Euro and USD .	Entweder Sie wählen Euro oder USD .
First part	Erster Teil
Simplified version of the innovative Stratos short .	Die kleine Schwester unserer innovativen Stratos Short .
The project is a project for the future proLIBERTAS .	Das Projekt ist ein Projekt für die Zukunft proLIBERTAS .
Thank you once again .	Nochmals vielen Dank .
Click here to return to the search form .	Klicken Sie hier , um zur Suchmaske zurückzukehren .
A process whose vision becomes a real adventure .	Ein Prozess , dessen Vision zum gelebten Abenteuer wird .
That is a situation which simply cannot be tolerated .	Dieses Problem darf einfach nicht so hingenommen werden .
Question No 5 by ( H ##AT##-##AT## 0785 / 99 ) :	Anfrage Nr. 5 von ( H ##AT##-##AT## 0785 / 99 ) :
Mr Smith mentioned the need for statistics .	Herr Smith erwähnte die Notwendigkeit von Statistiken .
You are here : Home &gt; France &gt; Paris &gt; 10 .	Sie sind hier : Startseite &gt; Frankreich &gt; Paris &gt; 10.
Without these changes the legislation will be toothless .	Ohne diese Änderungen werden die Vorschriften wirkungslos .
Applause	Beifall
Live Private Shows for as low as 0.98 Credits / minute !	Sehen Sie die LiveShows in 3D !
Be sure to check out our talent calculator and preview the changes !	Den aktualisierten Talentrechner findet ihr hier .
Both devices get delivered with SilverFast Ai 6.6 .	Beide Modelle werden mit SilverFast Ai 6.6 ausgeliefert .
The Poisinous Plants page is still under construction .	Die Giftige Pflanzen Seite ist noch in Arbeit .
Launch your photo editor and open the photo in it .	Öffnen Sie das Foto mit Ihrer Bildbearbeitungssoftware .
Control of malaria	Malariakontrolle
Maria Talis wrote a song for this occasion .	Maria Talis hat ein Lied für diesen Anlass geschrieben .
Today that is difficult and there are flaws in the system .	Dieses System ist heute höchst kompliziert und mangelhaft .
All your material is held in the strictest confidence .	Ihr Material wird streng vertraulich behandelt .
The Summit ’ s document on openness is a fig leaf .	Das Dokument des Gipfels zum Thema Offenheit ist ein Feigenblatt .
Your product is registered with Quark .	Ihr Produkt ist bei Quark registriert .
This will strengthen cohesion within the EU .	Dies wird die Kohäsion in der EU stärken .
The filename where the exception is thrown .	Der Name der Datei , in der die Exception aufgetreten ist .
What tax rates do they apply ?	Welchen Steuersatz sollen sie anwenden ?
We have not achieved a single one of the objectives .	Wir haben nicht ein einziges Ziel erreicht .
The next question is , ‘ What is this added value ? ’	Die nächste Frage lautet : Worin besteht dieser Zusatznutzen ?
Room Notes : Twin Bedded Room with ensuite bathroom .	Zimmerbeschreibung : Twin Bedded Room with ensuite bathroom .
A range of sensors ranging from 3k to ... 28K !	Eine Reihe von Sensoren im Bereich von 28K 3k zu ... !
There are many types or species of chords .	Es gibt viele Arten oder Arten von Akkorden .
Please use the returns form provided .	Benutze bitte hierfür das der Bestellung beigelegte Rücksendeformular .
Nobody connected its name with a concrete strategy .	Aber keiner hat den Namen mit einer konkreten Strategie verknüpft .
Italy and Luxembourg have temporarily banned it .	Italien und Luxemburg haben sie vorübergehend verboten .
To jump to the next match , just press ENTER .	Mit ENTER springen Sie zum nächsten vorhandenen Treffer .
I sympathise with the people fleeing the violence .	Ich habe Mitgefühl mit den Menschen , die der Gewalt entfliehen .
What does the Corporate PR department do ?	Was macht die Corporate PR Abteilung ?
Applause	Beifall
There will be new Iraq oil wars .	Es wird neue Ölkriege wie den im Irak geben .
Once again , this House is undermining its own foundations !	Damit demontiert sich dieses Haus einmal mehr !
There is no doubt about that .	Daran gibt es keinen Zweifel .
XVN original fans , instead Recommend this site !	XVN ursprünglichen Fans , statt Diese Seite empfehlen !
Where do I get support for Debian ?	Wo finde ich Unterstützung für Debian ?
Around this tower on the south side of the cap ...	In der Umgebung dieses Turms auf der Südseite ...
What we need is action .	Worauf es ankommt , sind Taten .
Of course not !	Natürlich nicht !
And so the moderate sum of 167 million will stand until 2004 .	So bleibt es bei den mäßigen 167 Millionen bis 2004 .
And why do you use our software ?	Und warum habt ihr euch für unsere Software entschieden ?
Alaska and Hawaii were added later .	Alaska und Hawaii kamen später hinzu .
Download the CD image from the torrent network .	Laden Sie das CD ##AT##-##AT## Image über das Torrent Netzwerk .
A new picture every week , every week a new page .	Es gibt für jede Woche eine neue Seite und eine neue Abbildung .
I want enlargement !	Ich will die Erweiterung !
Why purchase a basic server which does not suit your requirements .	Sie möchten keinen Server von der Stange ?
In Sweden the percentage is even higher than in Germany .	In Schweden ist dieser Prozentsatz noch höher .
0 votes &#124; 0 views &#124; 0 com .	0 votes &#124; 35 views &#124; 0 com .
They must be speedily adopted .	Sie müssen rasch umgesetzt werden .
( Parliament agreed to urgent procedure )	( Das Parlament beschließt die Dringlichkeit . )
Exposing my perfect body right in front of web camera ...	Meinen wundervollen Körper vor der Webcam zu präsentieren ...
Description : This is Resources for Vi &apos;start .	Beschreibung : This is Resources for Vi &apos; start .
Bielefeld , Chemnitz und Mainz kämpfen um den Titel ...	Infotag an der Handelshochschule Leipzig ( HHL ) am 19. ...
We need those programmes for our environmental aims .	Wir benötigen diese Programme für unsere umweltspezifischen Ziele .
Adjournment of the session	Unterbrechung der Sitzungsperiode
Saying this : of what does The dance of the Victory go ?	Ausdruck das : wovon geht Der Tanz des Siegs ?
We made our point .	Wir haben unseren Standpunkt dargelegt .
Tool to make a party ##AT##-##AT## evening more planable .	Tool zur besseren Planung eines Partyabends .
1 double room for 2 persons with shower / WC , no balcony .	1 Doppelzimmer für 2 Personen mit Dusche / WC ohne Balkon .
That is the situation confronting the European farmer .	Das ist die Situation für den europäischen Landwirt .
The decor is simple but stylish .	Die Dekoration ist einfach , dennoch sehr stilvoll .
And if so , on what facts are these constructions based ?	Und wenn ja : Auf welchen Tatsachen basieren diese Konstrukte ?
We are now in the European Union .	Wir sind jetzt in der Europäischen Union .
1 ) In 1976 Marcelo was 11 years old .	1 ) 1976 Marcel war 11 Jahre alt .
forums about Playa del aguila - Gran Canaria .	Foren über Playa del aguila - Gran Canaria .
Behind the wall was a stage set of a village yard .	Hinter dieser Mauer befand sich eine Art dörflicher Hof .
Create your character and join the Gold Rush !	Erstelle deinen Charakter und nimm am Goldrausch teil !
The Dimday Tribe ( A Defias Brotherhood Tribe ) .	Auf Worldofwar.de möchten wir euch mal auf die Szenereports hinweisen .
Department night : double room and bathroom with shower .	Abteilung Nacht : Doppelzimmer und Bad mit Dusche .
The Claus Event Center adjacent to ...	Apenheul ZOO WO 30 verschiedene Arten von Menschenaffen lebe ...
It would certainly be a service to the cause !	Der Sache täte das jedenfalls gut !
When would you like to stay at the Grand Hotel Ritz ?	Wann möchten Sie im Grand Hotel Ritz übernachten ?
Madam President , I will be brief .	( EN ) Frau Präsidentin ! Ich werde mich kurz fassen .
VOTE	ABSTIMMUNGEN
They need to be resettled in Europe .	Sie müssen in Europa neuangesiedelt werden .
The debate is closed .	Die Aussprache ist geschlossen .
When would you like to stay at the Alpha Hotel Le 21Ème ?	Wann möchten Sie im Alpha Hotel Le 21Ème übernachten ?
So what did you do ?	Und was haben Sie gemacht ?
There are currently 1871 users and 10541 guests online .	Zur Zeit sind 914 Benutzer und 7523 Gäste online .
At work , you will be watchful and attentive .	Im Arbeitsbereich werden Sie sehr vorsichtig und wachsam sein .
If the problem still exists , please contact us .	Falls das Problem weiterhin besteht , bitte kontaktieren Sie uns .
First of all , that is unattainable .	Erstens ist das unerreichbar .
... and afterwards a nice cup of coffee !	... und später eine gute Tasse Kaffee . Genuss pur !
Hotel had good facilities , was very quiet and comfortable .	Buffet for dinner and breakfast . Close to Terminal .
The load is smaller than Load ##AT##-##AT## Min ..	Die Beladung ist kleiner als die Min ##AT##-##AT## Beladung .
Use of these facilities is free for hotel guests .	Die Nutzung der Einrichtungen ist für Hotelgäste kostenfrei .
The offer is not available for less than 7 days of staying .	Das Angebot ist unter 7 Tage nicht gültig .
A night on Anak Krakatau ( 4 .	Eine Nacht auf dem Anak Krakatau ( 4.
The decisions are , however , just words on paper .	Die Beschlüsse sind allerdings nur Worte auf Papier .
The apartment is fully accessible for wheelchair users .	Die Wohnung ist vollständig für Rollstuhlfahrer zugänglich .
For what type of holiday would you like an offer ?	Für welche Art des Urlaubes wünschen Sie ein Angebot ?
For these reasons I have voted ‘ No ’ .	Aus diesen Gründen habe ich mit Nein gestimmt .
That is the challenge we must all rise to .	Das ist die Herausforderung , der wir uns alle stellen müssen .
The hotel is situated in the forest at the edge of Garderen .	Das Hotel liegt im Wald am Rande von Garderen .
We should take it as our example .	Das sollte uns als Beispiel dienen .
Qaddafi clearly preferred the latter .	Gaddafi hatte klare Präferenzen für letzteren .
Jean Michel Jarre is a prominent artist for sure .	Jean Michel Jarre gehört in jeder Hinsicht zu den größten Stars .
My entire delegation is pursuing a different path .	Wir gehen mit meiner gesamten Delegation einen anderen Weg .
Thus , our games are designed to be fair from the ground up .	Daher sind unsere Spiele schon von Grund auf fair .
31 He had on a loose robe of most exquisite a whiteness .	31 Er hatte ein loses Gewand von außergewöhnlicher a Weiße an .
This represents a genuine sea change .	Hier geht es um eine wirklich große Veränderung .
Below we have a few internet comments for you to read .	Unten kannst du ein paar Kommentare aus den Reiseforums lessen .
We have a cooperation agreement with that country .	Wir haben ein Kooperationsabkommen mit diesem Land .
The town of Hustopece is located at the 25th km - EXIT 25 .	Hustopeče befindet sich auf 26. Km der Autobahn - EXIT 25.
Does PEAR work on Mac OS X ?	Funktioniert PEAR unter Mac OS X ?
I believe this will happen .	Ich denke , dass das geschehen wird .
I am deputising for Mrs Hedkvist Petersen in the committee .	Ich vertrete die Kollegin Hedkvist Petersen im Ausschuss .
First of all , security in Europe .	Erstens : Sicherheit in Europa .
( The President spoke Georgian .	( Der Präsident spricht Georgisch .
The vote will take place on Thursday , 26 March 2009 .	Die Abstimmung erfolgt am Donnerstag , den 26. März 2009 .
After his death , it was finished by his son or one of his pupils .	Es ist heute in der Stadtkirche zu sehen .
Anudari wants to be a Farmer and live in the countryside .	Anudari möchte später Farmer werden und auf dem Land leben .
What is the situation today ?	Wie sieht die Lage heute aus ?
And we have not solved them yet .	Und das haben wir noch nicht getan .
- McCarthy report	- Bericht : McCarthy
Just select the cycle and press start .	Einfach den Zyklus auswählen und die Start ##AT##-##AT## Taste drücken .
This is especially relevant with the release of PHP 5 .	Dies ist besonders mit Blick auf PHP 5 von Bedeutung .
Do I want to propose my own system ?	Ich meine den Artikel Panarchie von P. E.
The finest spanish ham baguette snacks in Chiclana .	Das beste Schinkenbrot in ganz Chiclana .
The program is itself compiled by C + + Builder command ##AT##-##AT## line tools .	It will save you valuable time .
When would you like to stay at the Hôtel Le Rallye ?	Wann möchten Sie im Hôtel Le Rallye übernachten ?
This was , in particular , Dr Kouchner &apos;s ambition .	Dies war vor allem das Anliegen von Bernard Kouchner .
The room was clean and the staff friendly .	A well situated hotel with very good staff .
Winter in Shanghai is long , wet and cold .	Der Winter in Shanghai ist lange , nass und kalt .
The Council ’ s proposal has two parts .	Der Vorschlag des Rates besteht aus zwei Teilen .
Italy	Niederlande
There are two distinct parts to this town .	Es gibt zwei von einander getrennte Teile der Stadt .
Here all informations are given over to URL .	hier werden alle Informationen in der URL übergeben .
We are concerned about authoritarian tendencies in Russia .	Wir sind über autoritäre Tendenzen in Russland besorgt .
Welcome to the EurothermenResort Bad Ischl !	Therme in Österreich - EurothermenResort Bad Ischl !
Nonetheless , we all know that they are not enough .	Wir alle wissen aber , dass dies nicht ausreicht .
Thank you , Manuel Lobo Antunes .	Herzlichen Dank , Manuel Lobo Antunes !
Can a voice imitator crack VOICESAFE ?	In welcher Sprache wird die Bedienerführung angeboten ?
Perhaps you can have a private word with Mr Monti .	Sie können sich vielleicht persönlich an Herrn Monti wenden .
Did you know Carrom before ?	Kennen Sie bereits das Carrom Spiel ?
NEW YORK – The violence in Congo is unspeakable .	NEW YORK – Die Gewalt im Kongo ist unbeschreiblich .
They still do .	Und sie empfinden noch heute so .
You have my total support for that .	Sie haben dabei meine volle Unterstützung .
When you are on a wrong track , doubt is something good .	Wenn man auf dem falschen Weg ist , ist Zweifel etwas Gutes .
Book the best hostels in Bristol with Hostelsclub .	Bucht die besten Hostels in Bristol über Hostelsclub .
There is still a good deal wrong with this Statute , I believe .	Das hätte gerade noch gefehlt , denke ich .
CC : I also think it all went smoothly , ...	CC : Ich denke auch , es ging alles reibungslos , ...
Click HERE for details on tuberculosis .	Klicken Sie HIER für Details auf Tuberkulose .
Meeting of consultant on breastfeeding in Minsk .	Treffen der Berater auf das Stillen in Minsk .
From here you get to the garden with the ...	Von hier gelangt man in den Garten mit Terrasse und Pool . Eine Fre ...
With your good wishes it must be a success !	Mit Ihren guten Wünschen muss es ein Erfolg werden !
The EU has a key role to play in this regard .	Hierbei spielt die EU eine entscheidende Rolle .
This is what we have always said , this is what we are fighting for .	Mittlerweile hat er das unterschrieben .
The debate is closed .	Die Aussprache ist geschlossen .
0 votes &#124; 0 views &#124; 0 com .	0 votes &#124; 474 views &#124; 0 com .
2003 , European Year of People with Disabilities	2003 : Europäisches Jahr der Menschen mit Behinderungen
Our experience with this procedure has been good .	Wir haben mit diesen Verfahren gute Erfahrungen gemacht .
Service stabilizes in a HARD problem state .	Service stabilisiert sich zu einem HARD ##AT##-##AT## Problemzustand .
Absolutely not .	Absolut nicht .
A.S. is regularly engaged in current human aid projects .	A.S. engagiert sich regelmäßig in aktuellen Hilfsprojekten .
Mr President , you are indeed right to specify that point .	Herr Präsident ! Ihr Hinweis ist wirklich berechtigt .
Thank you .	Vielen Dank .
A case in point has been malaria control .	Ein typisches Beispiel ist die Bekämpfung der Malaria .
From 1991 onward , it furnishes the seconds of legal time .	Von 1991 an liefert sie die Sekunden der gesetzlichen Zeit .
When would you like to stay at the Hotel Al Saraceno ?	Wann möchten Sie im Hotel Al Saraceno übernachten ?
Why have a monetary Europe ?	Ein Europa mit gemeinsamer Währung , wozu ?
I am wholeheartedly in favour of family reunification .	Familienzusammenführung , ja !
John Paul II was no follower of neo ##AT##-##AT## liberalism .	Johannes Paul II. war kein Anhänger des Neoliberalismus .
Value for money as a basic appartment for short stay holiday .	Ich besuchte dieses Hotel schon mehrmals . Sehr ruhig .
We ’ d like to include you in this exciting process !	Und wir wollen Sie daran teilhaben lassen !
We will try and make sure it is corrected by tomorrow .	Wir werden versuchen , das bis morgen korrigieren zu lassen .
There are other countries in a similar situation .	Es gibt noch mehr solcher Länder .
The MTW Viking Invasion expansion ends in this year .	Die Erweiterung MTW Viking Invasion endet in diesem Jahr .
Darnassian is the primary language of night elves .	Darnassisch ist die Muttersprache der Nachtelfen .
I am particularly grateful to the Commissioner for that .	Dafür möchte ich dem Kommissar besonders danken .
37 Light and truth forsake that a evil one .	37 Licht und Wahrheit verlassen jenen a Bösen .
Written Statements ( Article 142 )	Schriftliche Erklärungen ( Artikel 142 )
- tea or coffee available in the bedrooms .	- Tee und Kaffee können nach Belieben im Zimmer zubereitet werden .
I am looking forward to it !	Darauf freue ich mich !
resaPark : book your parking space at the airport !	resaPark : reservieren Sie Ihren Parkplatz am Flughafen !
The cosy beer garden is open from May to September .	Der gemütliche Biergarten ist von Mai bis September geöffnet .
The forum began in late March 2002 .	Das Forum begann Ende März 2002 .
I must say , they really have a nerve !	Das , muss ich sagen , ist wirklich ein starkes Stück !
How should it be implemented ?	Und wie kommt es dazu ?
We are looking forward to your inquiries .	Falls Sie überzählige Maschinen haben , bitten wir um Ihr Angebot .
11 . Situation in Tibet ( vote )	11. Lage in Tibet ( Abstimmung )
The ski bus stop is only 70 metres away .	Die Skibushaltestelle ist nur 70 m entfernt .
0 votes &#124; 2 views &#124; 0 com .	0 votes &#124; 164 views &#124; 0 com .
Sondrio - Aprica - Via Privata Gemelli snc - Tel .	Sünders - Aprica - Via Privata Gemelli snc - Tel .
Menstruation calendar now also displays the date .	Menstruations Kalender zeigt jetzt auch das Datum an .
There have been 7104 ad views .	Es gab diesen Monat bisher 7105 Besucher .
You are always welcome to contact us .	Bitte fragen Sie bei uns an !
When would you like to stay at the Hotel Tivoli ?	Wann möchten Sie im Hotel Tivoli übernachten ?
Parking à disposition de la clientèle .	La finition de votre habitation sans déception !
In the two years filming Movies 1 and 2 , Emma spent 300 days on set .	Rupert denkt dass Emma etwas herrisch sein kann .
The legal consequences follow from Sec . 288 German Civil Code .	Die Rechtsfolgen bestimmen sich nach § 288 BGB .
That is absolutely clear .	Das ist ganz klar und eindeutig !
MoWeS was downloaded more than 1000 times .	Unser Usewareprojekt MoWeS wurde mehr als 1000x downgeloadet .
Hablade us that something is not working properly there .	Hablade uns , dass etwas nicht richtig funktioniert es .
