This is our responsibility .	Das ist unsere Aufgabe .
The Commission has now opened the debate .	Die Kommission hat die Debatte nunmehr eröffnet .
It is clearly not .	Das ist es ganz offensichtlich nicht .
This question is certainly still open .	Sicherlich ist auch das eine offene Frage .
- Production and bottling in the Property .	- Produktion und Abfüllung in die Immobilie .
I have not been able to take part in the last three votes .	Die letzten drei Abstimmungen konnte ich nicht mitmachen .
For groups , thank you for Contact us here .	Für Gruppen , ich danke Ihnen für Kontaktieren Sie uns hier .
I wanted to mention this first .	All dies wollte ich vorausschicken .
The roman god Neptune is identical to the greek god Poseidon .	Das römische Pendant zu Poseidon ist der Gott Neptun .
Any new language creates problems .	Jede neue Sprache bringt Probleme mit sich .
You wish to give new momentum to the European Union .	Sie wollen der Union eine neue Dynamik verleihen .
The KDE4 Versions are without Kanotix branding .	In diesen Versionen ist allerdings kein Kanotix Branding enthalten .
The Uighurs are a moderate Sunni minority .	Die Uiguren sind eine gemäßigte sunnitische Minderheit .
Sometimes it &apos;s made next to no time .	Dunkelstadt - Wie entferne ich eine Wand ?
And the problem is by no means new .	Es ist aber auch kein neues Problem .
The budget is a legal obligation for the Commission .	Der Haushalt ist eine rechtliche Verpflichtung für die Kommission .
And there are social reasons too .	Und es gibt noch einen sozialen Grund .
Thirdly , this is a multiethnic state .	Drittens , es ist ein multiethnischer Staat .
The Website has been created by Servathin .	Diese Website wurde von Servathin angelegt .
It was a shame but ultimately could not be a hunch .	Es war schade , aber letztlich konnte nicht eine Ahnung sein .
It will have to come clean on this in the trialogue .	Im Trilog muß er dazu Farbe bekennen .
Please , please ...	Bitte , bitte ...
Colleague Camisón had more difficulties .	Der Kollege Camisón hatte mehr Schwierigkeiten .
Subject : Cot deaths	Betrifft : Plötzlicher Kindstod
-3.3	-1,9
There is a grave difference here .	Dies ist ein gravierender Unterschied .
You can ask a question during the meeting from home .	Während des Satsangs kannst du eine Frage von Zuhause aus stellen .
et rien dans le groupe de démarrage .	les bonnes qualités que nous n &apos; avons pas .
Use the virtual office standard version .	Nutzen Sie die Standardversion des virtuellen Offices .
( The President cut off the speaker )	( Der Präsident unterbricht die Rednerin )
However , the frequency tuning is not automatic .	Allerdings erfolgt die Frequenzeinstellung nicht automatisch .
We lose it at our peril .	Wir verlieren sie auf eigene Gefahr .
Amendment No 592 , in line 18 03 05 , has been withdrawn .	Änderungsantrag 592 zur Linie 18 03 05 wurde zurückgezogen .
Pussy and ass with the fuckingmachine and peeing .	Fotze und Arsch mit Fickmaschine und pissen .
But for every athlete protection without joining .	Aber für jeden Sportler Schutz , ohne daran teilzunehmen .
The first sentence should be changed to read :	Der erste Absatz sollte wie folgt geändert werden :
They currently make up almost 54 per cent of all migrants .	Frauen stellen derzeit nahezu 54 % aller Migranten .
So that is what it is about .	Darum geht es also .
We remain determined to conclude Agenda 2000 .	Wir halten daran fest , die Agenda abzuschließen .
Please understand that there will be no development .	Verstehen Sie bitte , diese Entscheidung ist endgültig .
We look forward to take up contact with you .	Wir freuen uns auf Ihre Anfrage .
I look forward to hearing your opinions .	Ich freue mich auf Ihre Meinungen dazu !
Both talk grandiosely and profusely about impartiality .	Beide reden ständig in hochtrabender Weise von Objektivität .
Our rapporteur is absolutely right on that point .	Unser Berichterstatter hat in dieser Hinsicht völlig recht .
It is unity on what is a rare disease .	Es ist Einmütigkeit über eine seltene Krankheit .
Welcome to Seaside Hotel De Wielingen !	Willkommen im hotel De Wielingen am meer und lande !
Recommendation for second reading by Mr Cornelissen	Zur Empfehlung für die zweite Lesung Cornelissen
The personal information that Sylkemar S.a.s.	Die Verarbeitung Ihrer durch Sylkemar S.a.s.
in writing . - I strongly support this report .	schriftlich . - Dieser Bericht findet meine volle Zustimmung .
We too are with them .	Wir sind ebenfalls mit ihnen .
Example # 1 Example of connecting to LDAP server .	Beispiel # 1 Verbindung zu einem LDAP server .
iPad : a new device for iNavX ?	IPAD : neue Unterstützung für iNavX ?
in writing . - ( IT ) I voted in favour .	schriftlich . - ( IT ) Ich habe dafür gestimmt .
Guided tours and excursions in Andalucia .	Tours und Exkursionen mit Reiseführer in Andalusien .
Why must we do that ?	Warum ist das so wichtig ?
Both machines were equipped with an open width device .	Beide Maschinen waren mit einem Entdoubliergestell ausgestattet .
In any event , we shall look into it .	Wir werden das auf jeden Fall überprüfen .
I will be looking forward to that kind of good result in May .	Ich hoffe auf ein gutes Ergebnis im Mai .
The Commission accepts this amendment .	Die Kommission akzeptiert also diese Änderung .
That has to be the right way forward .	Auf die Erreichung dieser Ziele müssen wir uns konzentrieren .
It is about creating energy to inspire the people .	Es geht darum , Energie , um die Menschen zu begeistern .
We shall have to consider how to handle this .	Wir müssen einmal überlegen , wie wir das machen .
The vote will take place at 6.30 p.m.	Die Abstimmung findet um 18.30 Uhr statt .
I sincerely believe that they are not .	Aber , ehrlich gesagt , ich glaube das nicht .
That is a fact .	Das ist eine Tatsache .
A cluster of 16th century trulli in the Itria Valley .	Un borgo di trulli cinquecenteschi nella Val d ’ Itria .
Is it worth the cost ?	Ist das den Preis wert ?
( The President cut off the speaker )	( Der Präsident entzieht der Rednerin das Wort )
They do not .	Hat er nicht .
When would you like to stay at the Lisboa Central Park ?	Wann möchten Sie im Lisboa Central Park übernachten ?
This is the crucial thing !	Das ist der Kernpunkt !
That should be the rule .	Das sollte die Regel sein .
Before the vote on Amendment No 10 :	Vor der Abstimmung über Änderungsantrag 10 :
You are here : Home &gt; Why GKN Driveline ?	Sie sind hier : Home &gt; Warum GKN Driveline ?
So perhaps we can be spared this phoney pressure in the future !	Also , diese Druckkulisse kann man sich künftig sparen !
This is out of all proportion .	Das steht in keinem Verhältnis zueinander .
I am therefore voting against the motion tabled by Mrs Frassoni .	Also stimme ich gegen den Antrag von Monica Frassoni .
This is the only comment I am going to make today .	Damit möchte ich es diesbezüglich bewenden lassen .
The debate is closed .	Die Aussprache wird geschlossen .
We are probably going to have a High Representative .	Wahrscheinlich werden wir einen Hohen Vertreter bekommen .
These amendments are not part of the compromise .	Diese Änderungsanträge sind nicht Teil des Kompromisses .
Handles cable coils weighing up to 8 kg ( 17 lbs ) .	Für Kabelringe bis 8 kg ( 17 lbs ) Gewicht .
Change is needed .	Die Zeit ist reif für Veränderung .
The share of Moscow thus remained invariable – 37,7 % .	Der Anteil Moskaus blieb unveränderlich – 37,7 % dabei .
The debate is closed .	Die Aussprache ist geschlossen .
On the basis of what kind of constitutional vision ?	Aufgrund welcher konstitutionellen Vision ?
Using PayPal you can also pay with your credit card .	Mittels PayPal können Sie u.a. auch per Kreditkarte zahlen .
do you like La Perle Hotel Jerusalem ?	Magst du La Perle Hotel Jerusalem ?
Turning now to the facts of the matter .	Nun zum Sachverhalt selbst .
See you soon and greetings from Lucca .	Bis bald und Grüße von Lucca .
We also provide a new version of the image brochure .	Ebenso haben wir die Imagebroschüre überarbeitet .
And I think many people take hope of it .	Und ich denke , dass viele Menschen ihre Hoffnung aus der Musik nehmen .
Kosovo	Kosovo
The report commands a wide consensus of opinion .	Es ist wichtig , dass der Bericht breite Zustimmung erhält .
I think we can do that .	Ich denke , das ist machbar .
Here you will find large , deluxe accommodation .	Sie wohnen in großen komfortablen Zimmern .
Inaugural address by the President of the European Parliament	Antrittsrede des Präsidenten des Europäischen Parlaments
Well , that is for the subsequent speakers to decide .	Das müssen die nachfolgenden Redner entscheiden .
Surveillance must build on the existing instruments .	Die Überwachung muss auf den vorhandenen Instrumenten basieren .
Two scanners find more than one !	Zwei Scanner finden mehr als einer !
Adjournment of the session	Unterbrechung der Sitzungsperiode
We have at your entire disposal our know ##AT##-##AT## how ...	Wir stellen Ihnen unsere Kompetenz und Erfahrung ...
Want to start a franchise for Costasur in Barcelona ?	Möchtest du deine Costasur Franchise in Barcelona aufbauen ?
Unfortunately , however , this is the way things are .	Aber leider ist es eben so .
Greece would have sunk or swum on its own .	Griechenland wäre dann alleine versunken oder geschwommen .
The debate is closed .	Die Aussprache ist geschlossen .
Exemptions invite abuse .	Steuerbefreiungen laden zum Missbrauch ein .
Or need access to our Extranet ?	Oder benötigen Sie einen zugang zur Medienbibliothek ?
What relationship do women have with their lingerie ?	Welches Verhältnis haben Frauen zu ihren Dessous ?
The link is provided with the registration mail .	Der Link dafür wird ihnen mit der Registrierungsemail zugesendet .
Colleagues were talking about priorities .	Die Kolleginnen und Kollegen sprachen über Prioritäten .
Important Reminder : Check Your Time Zone Settings !	Anyone from the Bracknell , Wockingham or Ascot area ?
These are not the core issues .	Das sind nicht die Kernfragen .
Thank you very much .	Vielen Dank .
tossed into Fox River with him ?	Sara als Beweis , dass sie noch leben .
The vote will take place tomorrow at 11 a.m.	Die Abstimmung findet morgen um 11.00 Uhr statt .
We do not even have accurate numbers .	Wir wissen es nicht einmal genau .
Written statements ( Rule 142 )	Schriftliche Erklärungen ( Artikel 142 )
The vote will take place at 11 a.m.	Die Abstimmung findet um 11.00 Uhr statt .
Lightbox what is and what good !	Lightbox o que é e para que serve !
Why should they not protect us ?	Warum sollte es nicht auch uns beschützen ?
He was taken to hospital with a cut .	Er ist mit einer Platzwunde in ein Krankenhaus eingeliefert worden .
What are these issues ?	Worum geht es insbesondere ?
We need to think of them .	An die müssen wir denken .
Europe is at a crossroads .	Europa steht an einem Scheideweg .
Mobile home Type B Comfort ( 1 ##AT##-##AT## 6 pers .	Mobile home Type B Deluxe ( 1 ##AT##-##AT## 6 Pers .
There is , I believe , one hope left to us .	Ich glaube , eine Hoffnung bleibt uns noch .
Do not include more code than necessary though !	Allerdings sollten Sie auch nicht mehr Code als nötig mitschicken !
Variable list of arrays to recursively merge .	Variable Liste der Arrays , die rekursiv zusammengeführt werden sollen .
What other explanation could there be for omitting women ?	Wie erklären Sie sonst , daß Frauen hier nicht auftauchen ?
In the church of San Giuseppe 105 people were killed .	In der Kirche von San Giuseppe wurden 105 Menschen erschlagen .
That is why I voted in favour of immunity .	Aus diesem Grund habe ich für die Immunität gestimmt .
Mr Dell &apos;Alba , thank you for that explanation .	Herr Dell &apos; Alba , ich danke Ihnen für diese Erläuterungen .
It is a proposal on two levels .	Dieser Vorschlag umfasst zwei Ebenen .
It &apos;s like activating a switch on the bus ...	Es ist , als wenn ein Schalter am Bus betätigt wird ...
A united Europe or a united Euro ##AT##-##AT## Asia ?	Ein vereintes Europa oder ein vereintes Eurasien ?
Anything further than that is guesswork .	Alles andere ist Spekulation .
Therefore the season of 2007 is aborted for us .	Damit ist die Saison 2007 für uns vorzeitig beendet .
We now have to start looking to the future .	Nun müssen wir jedoch in die Zukunft blicken .
Here you will find all about life in and around the water .	Hier finden Sie alles über das Leben auf und am Wasser .
Here it is easy to name the failures .	Hier ist das Versagen einfach zu benennen .
Is it a comedy ?	Ist das eine Komödie ?
The Welcome Bonus is subject to our Bonus Policy .	Ihr Willkommensbonus unterliegt unserer Bonusregelung .
You can add more languages at any time later , if you wish .	Sie können später jederzeit weitere Sprachen hinzunehmen .
Around 1381 it was destroyed again by Timur .	Um 1381 wird sie durch Timur erneut zerstört .
That is very hard to believe today .	Heute ist das kaum mehr zu glauben .
The contestor is not allowed to see their moves .	Der Rekordbrecher darf beim Verdrehen nicht zusehen .
Perhaps the Commissioner would respond to this ?	Vielleicht wird der Herr Kommissar dazu noch Stellung nehmen .
Fresh coffe would have been lovely .	Die Mehrkosten für Taxis und der Zeitaufwand dafür gingen klar zu unseren Lasten .
We are all familiar with this subject .	Diese Tatsachen sind allgemein bekannt .
This is a package .	Dies ist ein Paket .
Transfers of appropriations : see Minutes	Mittelübertragungen : siehe Protokoll
To this end , we have an invaluable asset : growth .	Dazu verfügen wir über einen Trumpf : das Wachstum .
We will solve your enquiries promptly .	Wir werden Ihre Wünsche schnell erfüllen .
Stopp i avloppet i tvättstället - ofräscht .	Alldeles för varmt i rummet och kunde inte fixa värnen .
can be found here at very low prices .	kann hier zu sehr niedrigen Preisen zu finden .
Let me underline one point : pacta sunt servanda !	Ich betone : Pacta sunt servanda !
I think that this is only logical .	Das scheint mir also nur logisch zu sein .
Let us therefore uphold the freedom of Europe ’ s citizens !	Lassen Sie uns deshalb die Freiheit der Bürger schützen !
There are several explanations for this .	Dafür gibt es mehrere Erklärungen .
Fill in sequence name , company name ...	Füllen Sie in der Reihenfolge Name , Firma ...
Memories of the Great Depression are dying out .	Die Erinnerungen an die Große Depression sterben aus .
That is why we voted against .	Aus diesem Grund haben wir dagegen gestimmt .
Let us bring to bear our collective European experience .	Lassen Sie uns unsere gemeinsame europäische Erfahrung nutzen .
That is an outrageous lie !	Das ist eine unverschämte Lüge !
Looking for technical details nobody dared tell you ?	Sie wollen Details , die Ihnen niemand zu sagen wagte ?
This will also be a test for the EU ’ s solidarity .	Dies wird auch ein Prüfstein für die Solidarität in der EU sein .
The surrounding of the Mas have all the charm of Provence .	Jeder bezaubert ihn sie Die Provence ist im Dekor Mein .
By bus , it takes approximately 10 minutes to the beach .	Mit dem Bus gelangen Sie innerhalb von 10 Minuten zum Strand .
This has been respected .	Dies haben wir respektiert .
These are the most important things to me .	Das ist für mich überhaupt das Wichtigste . Bei einem früheren Datum – z.
When would you like to stay at the Ayre Gran Hotel Colon ?	Wann möchten Sie im Ayre Gran Hotel Colon übernachten ?
We have therefore voted against this report .	Aus diesem Grund haben wir gegen diesen Bericht gestimmt .
We want to play a leading role in the world .	Wir wollen in der Welt mit dirigieren .
We have to invest in more cultural freedom .	Wir müssen in größere kulturelle Freiheit investieren .
do you like Hilton Hotel Tel Aviv ?	Magst du Hilton Hotel Tel Aviv ?
The houses are empty , the villages are ghost towns .	Die Häuser sind verlassen , die Dörfer vergraben .
Resumption of the session	Wiederaufnahme der Sitzungsperiode
Thank you for your attention .	Danke für Ihre Aufmerksamkeit .
The prices are intendet for half board service in Euro .	Die Preise verstehen sich für Halbpension in Euro .
Let me take the example of Mr Donnelly &apos;s region .	Ich nehme mal Alan Donnelly und seine Region .
Mr Barroso has placed it at the top of his agenda .	Herr Barroso hat ihn ganz oben auf seine Agenda gesetzt .
His conclusions are completely justified therefore .	Seine Schlussfolgerungen sind mithin vollkommen begründet .
Look for line boundaries at newlines .	Es wird nach Zeilenbegrenzungen bei Zeilenumbrüchen gesucht .
Here you will find information about Costa Rica .	Hier finden Sie einige nützliche Informationen zu Costa Rica .
He was linked to us live from China by telephone .	Er war uns live über das Telefon aus China zugeschaltet .
Mutual benefits do undoubtedly flow from this fact .	Daraus ergeben sich zweifellos Vorteile für beide Seiten .
( The oral amendment was accepted )	( Der mündliche Änderungsantrag wird angenommen . )
The finals is where the ball stops in przegródce .	Das Finale ist , wenn die Kugel auf przegródce .
So they seldom have any translation in French or English .	Im allgemeinen ist von ihnen keine deutsche Form bekannt .
A pity , especially as things show so much potential .	Schade , besonders angesichts des großen vorhandenen Potenzials .
Subject : Merger between Suez and Gaz de France	Betrifft : Fusion von Suez und Gaz de France
As I said earlier , it is a matter of money .	Das ist , wie ich bereits erwähnt habe , eine Frage des Geldes .
Is this our aim ?	Streben wir sie an ?
&quot; to the lips of our customers around the world .	&quot; auf die Lippen unserer Kunden rund um den Globus .
Firstly , as regards politics .	Erstens zur Politik .
Does it matter ?	Ist das wichtig ?
Where can I order the current catalog for a fair or exhibition ?	Wo bekomme ich den jeweiligen aktuellen Messekatalog ?
Who ’ s he kidding ?	Wen will er damit ins Bockshorn jagen ?
And yes - no manual typing is required .	Und richtig - all das ohne die Daten mühsam einzutippen !
Service life makes 15000 cycles ( about 20 years ) .	Die Betriebsdauer ist 15000 Zyklen ( etwa 20 Jahre ) .
CAN I CHANGE THE SAILING ROUTE DURING THE HOLIDAY ?	KANN ICH DEN SEGELPLAN UNTERWEGS ÄNDERN ?
For these reasons I voted against this report .	Aus diesen Gründen habe ich gegen diesen Bericht gestimmt .
en - secur room – Seguridad Integral en viviendas .	de - secur room – Seguridad Integral en viviendas .
Toboggan Run Try to stay in the track to gain speed !	Toboggan Run Bleib in der Spur , um zu beschleunigen !
lftp has now been rebased to version 3.7.1 .	lftp wurde nun grundlegend aktualisiert auf Version 3.7.1 .
We should concentrate on two essential principles .	Wir sollten uns auf zwei unabdingbare Grundsätze konzentrieren .
My firm intention is to maintain that success .	Ich bin fest entschlossen , diesen Erfolg zu verteidigen .
Is it due to mere inadequacy and naivety ?	Ist es einfach Inkompetenz und Naivität ?
It is better than what you have usually come up with .	Es ist besser als das , was Sie sonst abgeliefert haben .
Welcome to Ruths Hotel and to Gl .	Willkommen in Ruths Hotel und in Gl .
– The debate is closed .	– Die Aussprache ist geschlossen .
Madam , you have taken advantage of my generosity .	Frau Kollegin , Sie haben meine Großzügigkeit ausgenutzt .
The hotel will be closed during the winter months .	Das Hotel bleibt über die Wintermonate geschlossen .
The ending is surprising and nice though . Smiles ...	Denn der Film ist sicherlich mindestens eine halbe Stunde zu ...
It sounds like the future – but it is reality already .	Was wie Zukunftsmusik klingt , ist längst Realität geworden .
Why ?	Warum ?
Mr President , just a final word .	Herr Präsident , nur noch ein abschließendes Wort .
Xgl Demo Live CD available ( Gentoo based , of course !	Xgl Demo Live CD draußen ( basiert natürlich auf Gentoo !
It affects them both .	Sie sind beide betroffen .
For France , there is no easy resolution .	Für Frankreich gibt es keine einfache Lösung .
The vote will take place tomorrow , 11 July 2007 .	Die Abstimmung findet morgen , am 11. Juli 2007 , statt .
This applies even more to the executive director .	Dies gilt insbesondere für den geschäftsführenden Direktor .
It is one of the bestbezahlten Brazilian models .	Es ist einer der bestbezahlten brasilianischen Modelle .
Please place orders for complete menus 3 days in advance .	Menübestellungen erbitten wir 3 Tage im Voraus .
Cederschiöld report ( A5 ##AT##-##AT## 0008 / 2000 )	Bericht Cederschiöld ( A5 ##AT##-##AT## 0008 / 2000 )
We do support the UN in this work .	Bei dieser Arbeit unterstützen wir die UNO .
Therefore , no , I am not ashamed .	Also nein , ich schäme mich nicht .
Unfortunately it was not .	Leider habe ich mich geirrt .
You have a beautiful view at the sea from all apartments .	Aus jeden Apartment haben Sie Blick zum Meer .
The debate is closed .	Die Aussprache wird geschlossen .
The vote will take place at 6.00 p.m.	Die Abstimmung findet um 18.00 Uhr statt .
In some countries it went down by as much as 70 % .	In einigen Ländern ging sie um bis zu 70 % zurück .
Resumption of the session	Wiederaufnahme der Sitzungsperiode
The landscape consists of four parts .	Die Landschaft besteht aus vier Teilen .
STEPS TO DO THE INSURANCE ?	WIE SCHLIESSE ICH DIE VERSICHERUNG AB ?
I do not believe that is true .	Ich glaube nicht , dass das stimmt .
Choose one to browse it and find the picture you want .	Wähle ein Set aus , um das gewünschte Bild zu finden .
Check out our new search engine .	Überprüfen Sie aus unserem neuen Search Engine .
Indeed it is not even a Member State issue .	Ja , sie ist nicht einmal die Sache eines Mitgliedstaats .
There is no maximum age for renting a car .	Er geldt geen maximum leeftijd voor het huren van een voertuig .
The vote will take place on Wednesday .	Die Abstimmung findet am Mittwoch statt .
I want to give a few examples of such changes .	Lassen Sie mich einige Beispiele für derartige Änderungen nennen .
This is an incredibly important issue .	Dies ist eine ausgesprochen wichtige Frage .
Many rural feast during the summer .	900 m vom Restaurant &quot; Il Castagno &quot; . Viele Einkaufsm � glichkeiten .
I think the question was already settled in July .	Ich glaube , daß diese Frage bereits im Juli beantwortet wurde .
Code of conduct for computerized reservation systems ( CRSs )	Verhaltenskodex für computergesteuerte Buchungssysteme
We took the chance and grabbed ...	Seid ihr interessiert ? Dann lest einfach d ...
Welcome to the pages of SzexMa.hu !	Sie suchen erotische Abenteuer oder Sex Partner ?
Dates of forthcoming sittings : see Minutes	Zeitpunkt der nächsten Sitzungen : siehe Protokoll
Enlargement may perhaps take place in 2003 .	Hinsichtlich der Erweiterung heißt es , daß sie im Jahre 2003 kommen kann .
Feel free to contact us !	Bitte zögern Sie nicht uns zu kontaktieren .
5 lifts transport mountain bikes ( ca .	5 Bergbahnen für den Biketransport ( ca.
Folland chelo21332 in Shemales horny ...	Josue auf Jungs Ich schoß zwei zur gleichen Ihnen ...
However , the excitement is riveting in both cases .	Wobei das Spielvergnügen in beiden Einrichtungen fesselnd ist .
People live and enjoy their lives in the same way as ever .	Die Bürger leben und genießen ihr Leben wie sonst auch .
I hope that we will soon make some progress on this .	Ich hoffe , dass wir da bald zu Fortschritten kommen .
Less injustice will increase the safety of us all .	Weniger Ungerechtigkeit erhöht unser aller Sicherheit .
If it is you that fail , the Commission too fails .	Wenn Sie versagen , versagt auch die Kommission .
The presentations will be held in French .	Die Vorträge werden in Französisch gehalten .
The UK Presidency was all about fine speeches .	Die britische Präsidentschaft war von schönen Reden gekennzeichnet .
Fill up that form with your questions .	Füllen Sie dieses Formular mit Ihren Fragen aus .
I confess to being a huge Lin fan .	Ich muss zugeben , ich bin selbst ein Riesenfan von Lin .
At the ITB in Berlin you ´ ll find us in hall 6.1 at stand 124 .	Auf der ITB finden Sie uns in Halle 6.1 am Stand 124 .
If you want to see more photos , check the Czech version .	Mehrere Fotografieren gibt es in Tschechische Version .
We must take a decision tomorrow .	Wir müssen morgen eine Entscheidung fällen .
Then you sit comfortably in your chair ....	Dann sitzt man bequem in Ihrem Stuhl .... Here we go !
The quiet street is a bonus .	Ein typisches kleines und nettes niederländisches Hotel .
That is therefore no longer a point of discussion .	Das steht also überhaupt nicht mehr zur Diskussion .
- How can I search for groups ?	- Wie kann ich für Gruppen suchen ?
I &apos;ve never been , but it will in no time !	Ich habe noch nie , aber es wird in kürzester Zeit !
Pashua is localized in English and German .	Pashua ist in Deutsch und Englisch lokalisiert .
Could you tell us about this urgent matter ?	Können Sie uns dazu etwas sagen ?
Not all .	Nicht alle .
So far , we have not seen that .	Davon haben wir noch nichts gesehen .
At the moment we are talking about tendencies .	Im Moment sprechen wir von Tendenzen .
indicates a line break and should not be changed .	steht für einen Zeilenumbruch und sollte nicht verändert werden .
Hardly any .	Kaum welche .
That is quite splendid .	Das ist ganz hervorragend .
Adjournment of the session	Unterbrechung der Sitzungsperiode
The Commission can accept the latter wording .	Die Kommission kann die letztgenannte Formulierung akzeptieren .
... of the Belliard building .	... des Belliard ##AT##-##AT## Gebäudes geht .
2001 gewannen sie den Pritzker Architecture Prize 2001 .	In 2001 they won the Pritzker Architecture Prize .
Get with the times , try new ways of advertising .	Bei Fragen steht unser Verkaufsteam Ihnen gerne zur Verfügung !
The second problem was more serious .	Das zweite Problem war gravierender .
So have a look at our Link pages .	Schauen Sie sich deshalb unsere seiten mit den links mal an .
Then just fill in our contact form .	Dann füllen Sie doch einfach unser Kontakt Formular aus .
Jetzt benötige ich zunächst einen Namen .	Créa ... a vous de relever le chalenge ! !
Eco ##AT##-##AT## label	Vergabe eines Umweltzeichens
Commerce does not want any limitations .	Die Wirtschaft will keine Einschränkungen .
It seems that those posters are outside the hemicycle .	Diese Plakate wurden anscheinend vor dem Saal angebracht .
This will lead to chaos .	Das wird zu Chaos führen .
The PikLoops repository is here .	Das Pikloops Repository ist unter here erreichbar .
It was not a “ farewell ” ; only a “ so long ” .	Es wird nicht ein endgültiger Abschied sein , sondern ein “ bis bald ” .
Please contact LAUDA direct with our inquiry form .	Zur Kontaktaufnahme steht Ihnen unser Anfrageformular zur Verfügung .
But , after all , perhaps I can afford a smile .	Aber vielleicht kann ich mir doch noch ein Lächeln abringen .
We are acting with as much transparency as possible .	Dabei agieren wir mit größtmöglicher Transparenz .
Ireland is a great country with amazing people .	Irland ist ein großartiges Land mit fantastischen Menschen .
Calendar of Part ##AT##-##AT## Sessions 1998	Tagungskalender 1998
We support you - no matter where you are in the world .	Logistik vor Ort . Wir unterstützen Sie - weltweit .
I can testify to this remarkable work .	Sie leisten wirklich beachtliche Arbeit .
If there &apos;s no other sheet needed , this one is .	Wenn man sonst keinen Bogen braucht , dann diesen .
So you are quite entitled to present it now .	Sie sind ja durchaus berechtigt , dies jetzt zu tun .
: rejected	lehnt
15 minute walk to old town centre .	Es wird dem Ambiente eines 4 Sterne Hotels mehr als gerecht .
If you got a couple , they remain turned .	Hast du ein Pärchen erwischt , bleiben sie umgedreht .
The Minutes of yesterday &apos;s session have been distributed .	Das Protokoll der gestrigen Sitzung wurde verteilt .
That is very important to us .	Das ist uns sehr wichtig .
The new ‘ plan D ’ ought to do both .	Der neue Plan D müsste beides leisten .
Mr President , I shall be brief .	Herr Präsident , gestatten Sie mir nur einen kurzen Hinweis hierzu .
Question No 9 by ( H ##AT##-##AT## 0552 / 00 ) :	Anfrage Nr. 9 von ( H ##AT##-##AT## 0552 / 00 ) :
But these are not normal times .	Doch sind dies keine normalen Zeiten .
Mr President , I will focus on two key issues .	– Herr Präsident ! Ich möchte zwei Punkte ansprechen .
Whilst staying at Eyre Sq Hotel , the location was excellent .	Clean rooms &amp; friendly staff at a good price .
Emiliano Bruni on my computer in the car . Install Centrafuse 3.0 .	Emiliano Bruni auf die EmiGreenScreen wurde geboren .
Unfortunately , this is not the case in the Roth report .	Leider ist dies im Roth ##AT##-##AT## Bericht nicht der Fall .
The debate is closed .	Die Aussprache ist geschlossen .
That is the EU &apos; s responsibility .	Dies liegt in der Verantwortung der EU .
The breath of another age permeates the monastery cloister .	Im Kreuzgang des Klosters geht der Atem einer anderen Zeit .
The name of the database that is to be selected .	Der Name der zu selektierenden Datenbank .
The timeframes are extremely long .	Es ist noch sehr viel Zeit .
So far not one penny has arrived .	Bisher ist noch kein einziger Cent angekommen .
Thank you , Mr Swoboda .	Vielen Dank , Herr Swoboda !
We will find a property for you .	Wir finden das passende Objekt für Sie .
As we all know , however , this is not the everyday reality .	Wie wir jedoch alle wissen , ist das nicht immer der Fall .
At this moment we do not have any vacancies available at Guylian .	Momentan haben wir keine offenen Stellen .
I mean consolidation , conditionality and communication .	Ich meine Konsolidierung , Konditionalität und Kommunikation .
Food is extremely cheap in Ghana .	Man bekommt an jeder Straßenecke etwas zu essen .
Dive into the sea of a thousand colours !	Tauchen Sie ein ins grossartige Farbenmeer !
do you like Kedem Towers Hotel Jerusalem ?	Magst du Kedem Towers Hotel Jerusalem ?
In which direction is the Commission leaning ?	In welche Richtung tendiert die Kommission ?
• At the helpdesk , additional FAQs are visible .	• Auf der Hilfeseite stehen Ihnen zusätzliche FAQs zur Verfügung .
It is particularly great in education .	Im Bildungsbereich ist dieses Spannungsverhältnis ganz besonders groß .
( Applause )	( Beifall )
Let me explain myself .	Dazu eine kurze Erläuterung .
or you can also use our contact form .	oder nutzen Sie unser Kontaktformular .
This seems like a kid who is waiting for Christmas .	Das ist wie bei einem Kind , das auf den Weihnachtsmann wartet .
How to get into the writing mode faster ?	Excellent pure writing software , very Zen feel .
That way , you will be happy .	Dann wären Sie zufrieden .
The ECR Group welcomes this debate .	Die EKR ##AT##-##AT## Fraktion begrüßt diese Aussprache .
Now France is making waves .	Jetzt schlägt Frankreich Wellen .
Thank you very much for your interest in CLICK2PAY !	Vielen Dank für Ihr Interesse an CLICK2PAY !
One of the most common of these STD ’ s is genital warts .	einer vom allgemeinsten dieser STD ist genitale Warzen .
My group absolutely refuses to approve this !	Meine Fraktion gibt dem jedenfalls nicht die Zustimmung !
0 votes &#124; 136 views &#124; 0 com .	7 Votes &#124; 10930 Abrufe &#124; 0 Komm .
Choose another route and do it urgently .	Wählen Sie eine andere Route , und zwar schnell .
This is bloody ridiculous !	Das ist doch einfach lächerlich !
&apos; Should not be expected to also work .	&quot; Bei der Arbeit sollte nicht erwartet werden .
Thank you for the statement .	Ich danke Ihnen für Ihre Stellungnahme .
A European agriculture market does not tolerate this .	Für einen europäischen Agrarmarkt ist dies nicht tragbar .
( The sitting was closed at 11.45 p.m. )	( Die Sitzung wird um 23.45 Uhr geschlossen . )
To view the page correctly must have JavaScript enabled !	Um die Seite korrekt zu öffnen , benötigen sie Javascript !
( DE ) Mr President , I have just one question .	Herr Präsident !
This is our magazine for customers and employees .	Unsere Zeitschrift für Kunden und Mitarbeiter .
Win instant cash &amp; free tournament play .	Mehr Informationen über die Verwendung von Gold Cards finden Sie hier .
Book the best hostels in Fenghuangxian with Hostelsclub .	Bucht die besten Hostels in Fenghuangxian über Hostelsclub .
We are cornering the cat .	Wir treiben die Katze in die Enge .
My fourth remark concerns the corridors .	Meine vierte Bemerkung bezieht sich auf die Korridore .
We need more research .	Wir brauchen mehr Forschung .
The office in Warsaw was opened in 2000 .	Das Büro in Warschau wurde im Jahre 2000 eröffnet .
Wed 28 Jan 2009 12 : 00 : 00 PM UTC — Deborah S.	Wed Jan 28 12 : 00 : 00 2009 – Deborah S.
However , this directive is essential .	Diese Richtlinie ist extrem wichtig .
fixed date / time bug in New QSO window .	spin buttons for time and RST fields in the New QSO window added .
The shortfall is huge .	Das ist ein großes Defizit .
But most of them turn away so that they hear not .	Doch die meisten von ihnen kehren sich ab , so daك sie nicht hِren .
It will be a pleasure to answer you .	Es wird uns eine Freude sein Ihnen zu antworten .
Watch our barbecues in action and get inspired !	Sehen Sie unsere Grills in Aktion und lassen Sie sich inspirieren !
I consider it very important .	Ich halte das für sehr wichtig .
The Source De la Loue sinks in rainfall ...	The Les Sources du Lison ist überflutet ...
President .	Die Präsidentin .
The closest parking parking is about 400 meter far .	Der nächste Parkplatz ist ca 400 Meter entfernt .
Wishing you every success !	Ihnen viel Erfolg !
The debate is closed .	Die Aussprache ist geschlossen .
Many older books have been acquired through donations .	Viele ältere Werke wurden uns durch Buchspenden vermacht .
Then there is the big problem of monetary policy .	Dann gibt es das große Problem der Geldpolitik .
( FR ) The debate is closed .	Die Aussprache ist geschlossen .
Television broadcasting	Ausübung der Fernsehtätigkeit
I speak for myself .	Ich sage das für mich .
Der Gegenbesuch fand statt vom 27 . Juli bis 03 .	Der Gegenbesuch fand statt vom 27. Juli bis 03 . August 2006 .
But I mean only partly .	Ich sage sehr wohl &quot; zum Teil &quot; .
The consequences may be dramatic .	Die Konsequenzen könnten dramatisch sein .
First of all , we would like to call attention to subsidiarity .	Erstens wollen wir auf die Subsidiarität hinweisen .
- Before the vote :	- Vor der Abstimmung :
&#91; 2004 / 2271 ( BUD ) &#93; ;	( 2004 / 2271 ( BUD ) ) ;
I thank you in this dual capacity ...	Sie vollbringen das Werk eines Antiquars und eines Künstlers .
I agree with everything that Mr Kallas has said .	Ich stimme allem zu , was Herr Kallas sagte .
Make a visit to Elinge Älgpark ...	Machen Sie einen Besuch im Elinge Älgpark ...
The single currency	Einheitliche Währung
Oh , if had a look under the spare tire !	Und wenn ich doch nur mal unter das Ersatzrad gesehen hätte !
Mr Posselt , the debate is closed .	Herr Posselt , die Aussprache ist geschlossen .
Washing mitt for wet removal of insects - NEW !	Handschuhe für nasses Entfernen von Insekten - NEU !
Why ?	Warum ?
The rural world is not homogenous .	Der ländliche Raum ist nicht homogen .
We expect reports on that .	Wir erwarten dazu Berichte .
We will expand the support of 64 bits later .	Die Erweiterung zu 64 bits erfolgt später .
Nice to see the word spread .	Schön zu sehen , wie es sich herumspricht .
To support this report would therefore be very risky .	Eine Unterstützung dieses Berichts ist daher sehr risikoreich .
The papers that I have so far ...	Die Papiere , die ich bisher aus ....
I believe that should be seen as an important factor too .	Auch dies ist meines Erachtens ein wichtiges Element .
In addition the signal quality was very poor .	Sonst war aber alles super freundlich !
Part Two	Zweiter Teil
This is what you call a DJs &apos; DJ .	So etwas nennt man einen DJ ’ s DJ .
This type of visit to the Commission is normal .	Derartige Besuche bei der Kommission sind normal .
Mr President .	Herr Präsident !
That is too much !	Ich halte das für übertrieben !
Then our position would be a truly European one .	Dann hätten wir eine echte europäische Position .
We must weigh up the implications of such action .	Dabei wären die Folgen unseres Tuns abzuwägen .
Liberia was Africa ’ s basket case .	Liberia war Afrikas Armenhaus .
I bid you a warm welcome !	Herzlich willkommen !
There are many thermal and mineral waters and spas .	Es gibt viele Thermal- und Mineralwasser und Spas .
That is right and proper .	Das ist gut und richtig .
They therefore stand adopted .	Sie sind also angenommen .
Written statements ( Rule 149 )	Schriftliche Erklärungen ( Artikel 149 )
Sonata for violoncello and piano in G minor op .	Sonate für Violoncello und Klavier g ##AT##-##AT## Moll op .
These words were echoed loudly in Portugal .	Diese Worte wurden in Portugal vernommen und deutlich unterstützt .
What Europe ?	Was für ein Europa ?
And that is what we are talking about .	Darum geht es , meine Damen und Herren .
It was time to see it in France !	Es war Zeit , um es in Frankreich !
However , there is still much progress to be made .	Es sind jedoch noch zahlreiche Fortschritte erforderlich .
for all bulk goods or sludges and pastes .	für alle Schüttgüter oder Schlämme und Pasten eingesetzt werden .
We have been presented with legal excuses .	Uns sind rechtliche Entschuldigungen präsentiert worden .
Finally , this programme leaves many questions unanswered .	Des Weiteren lässt das Programm zahlreiche Fragen offen .
That is how the Council comes across to the public .	Das ist das Erscheinungsbild des Rates in der Öffentlichkeit .
Read our proposal .	Lesen Sie unseren Vorschlag .
The exact date of broadcasting is not yet clear .	Der genaue Sendetermin steht noch nicht fest .
We offer to you the services of every type .	Wir bieten Ihnen die Services jeder Art an .
Approval of the Minutes of the previous sitting	Genehmigung des Protokolls der vorangegangenen Sitzung
Paid4Surf earn money for surfing + Paid4Ref !	Paid4Surf Geld fürs surfen verdienen + Paid4Ref !
It has not pretended that everything is all right .	Sie versucht nicht vorzugeben , daß alles in Ordnung sei .
We cannot think of a good reason to postpone it .	Uns sind keine triftigen Gründe für eine Vertagung bekannt .
For this , you need only to contact us .	Das einzige was Sie tun müssen ist , uns zu kontaktieren .
The hotel rooms were spacious and very comfy .	Das Hotel ist gepflegt und sehr sauber .
Just being there is difficult enough .	Das Dasein ist schon anstrengend genug .
Some even said her work was unbuildable .	Manche sagten sogar , ihre Raumkonzepte seien nicht umsetzbar .
Then you are exactly right with us !	Dann bist du bei uns genau richtig .
Content is the king , but only a quality one is .	Der Content ist der König , wenn er allerdings gut geschrieben ist .
Book the best hostels in Itacaré with Hostelsclub .	Bucht die besten Hostels in Itacaré über Hostelsclub .
And for years the mounting losses were ignored .	Man hat auch jahrelang die steigenden Verluste ignoriert .
Good variety and quality of breakfast .	The hotel was located in a very good place for sight ##AT##-##AT## seeing .
If you run out of health , your character will die .	Wenn einem Charakter die Gesundheit ausgeht , stirbt er .
Let us stop being hypocritical .	Lassen wir die Heuchelei .
We need to see continued improvement in human rights .	Wir wollen eine ständige Verbesserung der Menschenrechtslage .
26 . Impact of EU development policy (	26. Wirkung der EU ##AT##-##AT## Entwicklungspolitik (
We have made this our life ’ s work .	Das haben wir zu unserem Lebenswerk gemacht .
Then we have to work on concrete indicators .	Danach müssen wir uns den konkreten Indikatoren zuwenden .
Getting away on a short holiday for a few days !	Für ein paar Tage auf Urlaub fahren !
Mr Barroso is not the man for the job .	Herr Barroso ist nicht der Richtige für diese Arbeit .
Surely that cannot be in our interest .	Das kann und darf nicht in unserem Interesse sein .
This is free and without commitment .	Dies ist kostenlos und verpflichtet zu gar nichts .
A transfer service by the hotel minibus is available .	Ein Shuttleservice per Minibus steht zur Verfügung .
Vice ##AT##-##AT## President of the Commission .	Vizepräsident der Kommission .
If you start something , you have to see it through .	Wer A sagt , der muß auch B sagen .
However , such crises recur again and again .	Allerdings finden diese Krisen häufig statt .
The third issue is Tampere .	Der dritte Punkt bezieht sich auf Tampere .
We will not receive unstamped packages !	Wir nehmen keine unfrankierten Pakete an !
But the respite was short ##AT##-##AT## lived .	Die Erholung war aber nur von kurzer Dauer .
So why do we not create a flexible budget ?	Warum also schaffen wir nicht einen flexiblen Haushaltsplan ?
When playback is stopped , the setting is disabled .	Wenn Sie die Wiedergabe stoppen , wird die Einstellung deaktiviert .
Hence our vote against .	Deshalb haben wir dagegen gestimmt .
Nothing would remain of the high ambitions entertained .	Von den ehrgeizigen Zielen würde nichts übrig bleiben .
How does the counter function without registering ?	Wie funktioniert der Counter ohne Registrieren ?
8 And the Lord is near , and he a justifieth me .	8 Und der Herr ist nahe , und er rechtfertigt mich .
You might consider using a real translator .	Sie können sich überlegen , einen Übersetzer zu beauftragen .
( Continuing protests )	( Anhaltender Protest )
Immigrant families have this right as well .	Dieses Recht gilt auch für Migrantenfamilien .
This too should be given due consideration .	Meines Erachtens sollte auch dies gebührend berücksichtigt werden .
Read More about Friends of Maria De Filippi !	Lesen Sie den Rest auf Freunde von Maria De Filippi !
Book the best hostels in Los Andes with Hostelsclub .	Bucht die besten Hostels in Los Andes über Hostelsclub .
You can trust us .	Darauf können Sie sich verlassen .
And that is the most rewarding experience of all .	Dies war die lohnendste Erfahrung von allen .
The credibility of the European Union is at stake .	Es geht um die Glaubwürdigkeit der Europäischen Union .
John Jackson and Jack Johnson grew up as orphans .	John Jackson und Jack Johnson wuchsen als Waisenkinder auf .
Men is zo gastvrij en vriendelijk , onvoorstelbaar .	Man ist unvorstellbar gastfrei und freundlich .
There is no priority submit for Google .	Es gibt keine Sonderanmeldung bei Google .
Attention : this page is only for dealers .	Achtung : Diese Seite ist nur für Händler bestimmt !
We will eventually pay the price .	Wir werden letztliich den Preis dafür bezahlen .
Ditto for the market in domain names .	Gleiches gilt für den Markt für Domain ##AT##-##AT## Namen .
Just talk to us - we are pleased to serve you !	Sprechen Sie uns einfach an - wir freuen uns auf Sie !
Een goed hotel waarin het prettig verblijven is .	Die Freundlichkeit des Personals , die Sauberkeit und der Stil .
On the workstation , there is a process called ypbind .	Auf dem Client gibt es den Prozess ypbind .
This is very much under way in FESCO .	Diese Arbeit kommt im FESCO gut voran .
Thank you for your comments , Mrs Cresson .	Madame Cresson , Herr Präsident ! Ich danke für Ihre Ausführungen .
None whatsoever .	Gar keinen .
. I have voted against the Interinstitutional Agreement .	Ich habe gegen die Interinstitutionelle Vereinbarung gestimmt .
We never heard of breeding of species not mentioned .	Nachzuchten der nichtgeannten Gattungen sind bisher nicht bekannt .
For how long my uploaded file will be stored on DepositFiles ?	Wie lange werden meine Dateien gespeichert ?
I would be extremely concerned if this were the case .	Das würde mir große Sorgen bereiten !
All forms of research must be encouraged .	Die Forschung in all ihren Formen muss gefördert werden .
- Is the price per guest or per room ?	- Verstehen sich die Preise pro Person oder pro Zimmer ?
( The sitting was closed at 7.30 p.m. )	( Die Sitzung wird um 19.30 Uhr geschlossen . )
The vote will be taken tomorrow at noon .	Die Abstimmung findet morgen um 12.00 Uhr statt .
Written statements ( Rule 149 )	Schriftliche Erklärungen ( Artikel 149 )
The beachside town of Mahahual faces a similar problem .	Die Küstenstadt Mahahual hat ein ähnliches Problem .
There was also financial arbitration in Berlin .	In Berlin sind auch finanzielle Entscheidungen getroffen worden .
The vote will take place tomorrow .	Die Abstimmung erfolgt morgen .
This is therefore a huge tragedy .	Deshalb ist dies eine enorme Tragödie .
The German completed 107 laps , the Swiss 92 .	Die deutsche 107 Runden abgeschlossen , die Schweizer 92.
Let us see how all this works in practice .	( EN ) Warten wir ab , wie das Ganze in der Praxis funktioniert .
This is now changing .	Dies ändert sich jetzt .
INTERNSHIPS DH FAST RIDING PEOPLE ARE 2010 ONLINE !	PRAKTIKA DH schnelles Fahren PEOPLE ARE 2010 online !
However , enforcement remains weak .	Bei der Durchsetzung dieser Regelungen gibt es allerdings noch erhebliche Probleme .
Let the sample will tell a joke !	Wenn auch das Muster die Anekdote erzГ ¤ hlen wird !
It seemed to be the overall solution .	Dies erschien als die Patentlösung .
Our Guest House is open the whole year .	Das Gasthaus ist das ganze Jahr über offen .
My friend Simecek was hit by a bullet in his neck .	Meinen Gefährten Šimeček traf die Kugel in den Hals .
They cannot afford lawyers .	Die können sich die Anwälte nicht leisten .
So let me express my sincere thanks to them too .	Deshalb herzlichen Dank !
An excellent team to guarantee your holidays !	Perfektes Teamwork - eine Garantie für Ihren Urlaub !
We have a long way to go .	Wir haben noch einen weiten Weg vor uns .
Test it NOW for 30 days : absolutely free .	Jetzt 30 Tage lang ReplyButler kostenlos testen .
( Parliament rejected the proposal )	( Das Parlament lehnt den Antrag ab . )
It was a privilege to be able to work with Anna .	Es war ein Privileg , mit Anna zusammen arbeiten zu können .
Yet I do not think our work ends there .	Dennoch glaube ich nicht , dass unsere Arbeit hier getan ist .
Documents received : see Minutes	Vorlage von Dokumenten : siehe Protokoll
Sorry , no object matches your search criterias .	Der Suchauftrag hat zu keinem Ergebnis geführt .
They were not always in accord , Commissioner .	Sie waren sich nicht immer einig , Herr Kommissar .
In 1980 has finished Uzhhorod State University .	Hat im Jahr1980 die staatliche Universität Uzhorod abgeschlossen .
0.93 vol . % argon is included in the atmosphere .	Es ist zu 0,93 Vol . % in der Atmosphäre enthalten .
In the third there was the lengthy conciliation procedure .	Ich weiß es nicht ganz genau .
I would certainly consider booking to stay there again .	I will be staying again in the future .
That is our main goal now .	Das ist derzeit unser wichtigstes Ziel .
All information is subject to our General Sales Conditions .	Alle Informationen unterliegen unseren AGB .
In my view , that can only be the Commission .	Ich bin der Meinung , dass das nur die Kommission sein kann .
Nevertheless , I wish this country well .	Trotzdem wünsche ich diesem Land alles Gute .
How do I access my UNYK account ?	Wie habe ich Zugriff auf mein UNYK ##AT##-##AT## Konto ?
Prizes are divided into 5 categories .	Die Gewinne werden in 5 Gewinnklassen aufgeteilt .
4 votes &#124; 55 views &#124; 0 com .	1 vote &#124; 1645 views &#124; 0 com .
But enlargement will not happen overnight .	Eine Erweiterung kann allerdings nicht über Nacht erfolgen .
Nevertheless , we ought to keep to our speaking times .	Aber wir sollten uns schon an die Zeit halten .
Thank you , Commissioner .	Vielen Dank , Herr Kommissar .
Will it be BENEFICIAL to all concerned ?	Wird es dem WOHL aller Beteiligten dienen ?
This article has been viewed 377 times .	Dieses Angeot wurde 378 Mal aufgerufen .
Products and services for industrial customers .	Produkte und Dienstleistungen für industrielle Großverbraucher .
Parliament in no way can condone this 4 % figure .	Das Parlament kann diese Zahl von 4 % keinesfalls vergeben .
Thirdly : what potential is open to us to make savings ?	Drittens : Welches Einsparungspotenzial haben wir ?
The agreements are already in existence .	Die Verträge sind schon in den Schubladen .
� obavi pregled radova u odre � enoj fazi gra � enja .	– obavi pregled radova u odreðenoj fazi graðenja .
When would you like to stay at the 1 Via Dei Valeri ?	Wann möchten Sie im 1 Via Dei Valeri übernachten ?
Member of the Commission .	Mitglied der Kommission .
Tariff : 260 € including all taxes per hour by anybody .	Tarif : 260 € TTC pro Stunde pro Person .
Europe needs new impetus .	Europa braucht Impulse .
When will my storage be available ?	Wie lange dauert es , bis gekaufter Speicher verfügbar ist ?
You must stick to that .	Daran muß man sich halten .
That is of vital importance .	Das ist von wesentlicher Bedeutung .
LANXESS is a major supplier of phosphorous compounds .	LANXESS ist ein führender Anbieter von Phosphorverbindungen .
Nor will they be borne by the structural funds .	Sie werden auch nicht durch die Strukturfonds getragen .
Eva swims and dives a lot in the water .	Eva schwimmt und taucht viel im Wasser .
file , PHP can be enabled or disabled .	Datei benutzen , kann PHP gezielt aktiviert bzw. deaktiviert werden .
I will mention four main areas .	Ich nenne vier wesentliche Bereiche .
Format : A2 ( 420 x 594 mm ) or A3 ( 297 x 420 mm ) .	Format : A2 ( 420 x 594 mm ) oder A3 ( 297 x 420 mm ) .
Ladies and gentlemen , what is it that Europe needs ?	Was braucht Europa ?
The role of the European Union is to help them .	Es ist die Aufgabe der Europäischen Union , sie dabei zu unterstützen .
Define where you want to create a new folder .	Definieren Sie wo Sie einen neuen Ordner erstellen möchten .
I would therefore beg to differ with the previous speakers .	Meinen Vorrednern muss ich deshalb widersprechen .
Since March , I have personally involved myself in this matter .	Seit März befasse ich mich persönlich mit diesem Thema .
( The sitting was opened at 09 : 05 )	( Die Sitzung wird um 09.05 Uhr eröffnet )
It is located directly opposite the main train station .	Das Hotel befindet sich direkt gegenüber dem Hauptbahnhof .
Once again , words and deeds point in different directions .	Wieder einmal folgen den Worten keine Taten .
We cannot afford to waste any more time .	Wir haben keine Zeit mehr zu verlieren .
The debate is closed .	Die Aussprache ist geschlossen .
The music was conjured up in two studios , including Cole ’ s new home studio .	Dort sang sie fast alle Gesangstakes .
Welcome in this peace of paradise !	Herzlich willkommen in diesem kleinen Paradies !
Nothing too heavy or difficult to do , right ?	Nichts zu schwer oder schwierig zu tun , nicht wahr ?
This is the reason for all the doping .	Das ist die Ursache für das Doping .
What do you particularly like about the ZTM 3697 ?	Was gefällt Ihnen an der ZTM 3697 besonders ?
And for this reason , I will vote in favour of the report .	Und aus diesem Grund stimme ich für den Bericht .
And to what end ?	Was hat das gebracht ?
Natural stems with textile blossoms and leaves .	Naturstämme mit textilen Blüten und Blättern .
Enhanced surveillance also is needed .	Auch eine ausgedehntere Überwachung ist vonnöten .
Pretty nice beach next to the hotel .	We booked an apartment with a balcony .
You have reached our page for El Hierro hotel reservation .	Dies ist die Seite für El Hierro Hotel Buchungen .
But of course he is a New Labour Member .	Aber er ist ja natürlich ein Mitglied von New Labour .
Rooms comfortable and clean if on small side .	The rooms were small but comfortable . Excellent value for money .
We will have to address this issue .	Wir müssen uns mit dieser Frage ause inander setzen .
&apos; To be continued &apos; , is the message , then .	Die Botschaft lautet also : Fortsetzung folgt .
We wish you success in aquiring your house or apartment .	Auf jeden Fall wünschen wir viel Erfolg bei der Suche .
Stop replication on a slave server .	Beendet die Replikation auf einem Slave ##AT##-##AT## Server .
What is our response ?	Was ist unsere Antwort ?
Europe can offer better education for everybody .	Europa kann allen Menschen eine bessere Bildung bieten .
That is what I want .	Genau das will auch ich .
Question Time ( Council )	Fragestunde ( Rat )
Question No 8 by ( H ##AT##-##AT## 0253 / 01 ) :	Anfrage Nr. 8 von ( H ##AT##-##AT## 0253 / 01 ) :
I now give the floor to Mr Lange , the rapporteur .	Das Wort hat der Berichterstatter , Herr Lange .
What do these words mean ?	Was bedeuten diese Worte ?
They are also not yet out of junior school .	Außerdem sind sie noch mitten in der Schulzeit .
Long veins at Voloshin Alexey Tolstoy .	Lange der Sehnen bei Woloschin Aleksej Tolstoj .
It would be difficult for a budget to be any more explicit .	Ein Haushaltsplan könnte wohl kaum deutlicher sein .
Today is the tenth of April .	Wir haben heute den 10. April .
Together , we can achieve a great deal .	Gemeinsam können wir viel bewirken .
The world &apos;s widest product range of fans and motors .	Das weltweit breiteste Programm an Motoren und Ventilatoren .
But more steps are needed .	Allerdings sind noch weitere Schritte nötig .
I do not understand the authors of that amendment .	Ich verstehe die Verfasser dieses Änderungsantrags nicht .
Become engrained pirate and sail into adventure of the wild Kornati Islands .	Wollen Sie ein echtem Pirat werden ?
Thank you , Commissioner Byrne .	Ich danke Herrn Kommissar Byrne .
Catalogue with a wide variety of erotic products .	Catalog cu o gama variata de produse erotice .
For additional OEMs please contact us .	Weitere OEMs unterstützen wir auf Anfrage .
- How do I delete a file or folder ?	- Wie lösche ich eine Datei oder einen Ordner ?
Click thumbnail to see larger photo .	Klicken Sie auf ein Bild , um ein größeres Foto von The Kenilworth anzuzeigen .
The result must be obvious .	Der Effekt kann ihnen klar sein .
Favourite food - všechno kromě rizota a vnitřností .	Lieblingsgericht - všechno kromě rizota a vnitřností .
Your activities for your perfect family vacations in Costa Rica .	Eine Aktivität für den perfekten Familienurlaub .
To date we have had minimal resources .	Bisher standen uns minimale Mittel zu Verfügung .
Baltic initiative	Initiative für den Ostseeraum
Plooij ##AT##-##AT## Van Gorsel report	Zum Bericht Plooij ##AT##-##AT## Van Gorsel
What is it about ?	Worum geht es ?
XVN is that it was unlimited download Please .	XVN ist , dass es unbegrenzte Download Bitte .
Not at all .	Keinesfalls .
Enjoy the view over the Na &apos;ama Bay .	Genießen Sie den wunderbaren Blick über die Na &apos; ama Bay .
These are now working .	Diese funktionieren nun .
Nevertheless , I would ask you not to wait .	Ich bitte Sie allerdings , die Dinge nicht auf die lange Bank zu schieben .
Subject : Korea FTA	Betrifft : Freihandelsabkommen mit Korea
The following questions are addressed to the Council .	Wir behandeln die folgenden Anfragen an den Rat .
CanI buy the Amulet Browser Chip separately ?	Kann ich den Amulet Browser Chip separat erwerben ?
##AT## lifehousemusic when are you going to Brazil ?	##AT## Lifehousemusic wann werden Sie nach Brasilien ?
Once chosen we never let down .	Autokomfort wird Sie nie enttäuschen , denn auf uns ist Verlass .
For this reason we find any delay unacceptable .	Aus diesem Grunde halten wir jede Verzögerung für nicht hinnehmbar .
I intend to learn as many new things as possible .	Ich möchte so viel Neues wie möglich lernen .
We demand his immediate and unconditional release .	Wir fordern seine sofortige und bedingungslose Freilassung .
I welcome this debate .	( EN ) Ich begrüße diese Aussprache .
Mr President , this is about the bananas .	- Herr Präsident , es geht hier um die Bananen .
Maine coon cat is a massive , robust cat .	Maine Coon Katze ist eine massive und robuste Katze .
Disparities would become still greater .	Das Wohlstandsgefälle würde sich hierdurch nur noch vergrößern .
They are 7 weeks on the photos .	Ihrer sein der bild ist 7 wochen .
I am sure she would support that point of view .	Ich bin sicher , die Frau Abgeordnete hat dafür Verständnis .
Q : How do I learn more about the Arena System ?	F : Wo kann ich mehr über das Arena ##AT##-##AT## System erfahren ?
Today , 7 visits , from 11 juuni 2009 931 visits .	Heute , 26 Besuche von 11 juuni 2009 930 Besuche .
23 . AIDS ( vote )	23. Aids ( Abstimmung )
Academic licenses are available on request .	... erhalten auf Anfrage gerne spezielle Konditionen und Rabatte .
First point : I support the report .	Erstens : Der Bericht erhält meine Unterstützung .
To buy EQ2 Plat , visit the EQ2 Plat page .	Um EQ2 Plat zu kaufen , besuchen Sie bitte die EQ2 Plat Seite .
Plumbing designed to minimize water usage .	Besondere Klempnerarbeiten , um den Wasserverbrauch zu reduzieren .
Caution is therefore advisable .	Deshalb müssen wir in dieser Frage Vernunft walten lassen .
Our full support is therefore required .	Daher wird hier unsere volle Unterstützung vonnöten sein .
This is another way to use this Convention .	Auch in dieser Weise kann der Konvent genutzt werden .
Look out for upgrades and good luck .	Suche nach Upgrades und viel Glück !
This cannot continue .	Dies darf nicht weitergehen .
However , the report also looks to go further .	Der Bericht geht jedoch noch weiter .
It profits from great work of restoration since 1988 .	Il bénéficie de grands travaux de rénovation depuis 1988 .
Our own is not how much is that ?	Unsere eigene ist nicht , wie viel ist das ?
All ready : you can depart with no worries !	Sie können ruhig und gedankenlos in den Urlaub mit AVI Travel starten !
Here you can subscribe to the Newsletter Stubai Glacier .	Hier können Sie unseren Gletscher Newsletter abonnieren .
The Hotel Maison Rouge is a wellspring for the curious .	Das Hotel Maison Rouge macht neugierig .
Targeting that figure means targeting its heart .	Wer auf diese Person zielt , zielt auf das Herz .
The economic and trading environments remain high risk ...	Wirtschaft und Handel sind immer noch Risiko belastet ...
Find and click on your project .	Finden und klicken Sie auf Ihr Projekt .
The majority of Israelis understand this .	Die Mehrheit der Israelis ist sich darüber im Klaren .
No server needed : We provide a permanent service !	Kein Server notwendig : Wir bieten einen permanenten Service !
I have a clear answer to that : no !	Meine klare Antwort ist : Nein !
However , there is still a lot of work to be done .	Es bleibt allerdings noch viel zu tun .
Thank you very much for your interest to visit BigSister .	Vielen Dank für Ihr Interesse an einem Besuch im BigSister .
I &apos;ve fallen in love with you and you haven &apos;t .	Ich habe mich in dich verliebt , und du nicht in mich .
We will continue to monitor this in the near future .	Wir werden unsere Überwachung in der nächsten Zeit fortsetzen .
Perhaps not Sarge . He was pretty much his usual self .	Her thumb hovered above the box .
- Before the vote	- Vor der Abstimmung
. I am aware of the issues that you raise .	. Dieses Problem ist mir bekannt .
We encourage you to make the same decision .	Wir ermutigen Sie , die gleiche Entscheidung zu treffen .
The rooms and beds were very comfortable with modern amenities .	Close to the center , to the metro , clean and quiet .
I also feel I have a duty to the institution .	Zudem fühle ich mich unserem Gemeinschaftsorgan verpflichtet .
Approved capital of CHF 29.8 million renewed .	Genehmigtes Kapital in der Höhe von CHF 29.8 Mio. verlängert .
0 votes &#124; 126 views &#124; 0 com .	0 votes &#124; 203 views &#124; 0 com .
Click thumbnail to see larger photo .	Klicken Sie auf ein Bild , um ein größeres Foto von La Residenza anzuzeigen .
One very important product it covers is Nifursol .	Ein ganz wichtiges Produkt unter diesem Oberbegriff ist Nifursol .
That is subsidiarity .	Das ist Subsidiarität .
Thank you , Mrs Plooij ##AT##-##AT## Van Gorsel .	Vielen Dank , Frau Abgeordnete Plooij ##AT##-##AT## van Gorsel .
Are central bankers and finance ministers not redundant ?	Sind nicht Zentralbänker und Finanzminister austauschbar ?
They will hopefully be concluded by April .	Sie finden hoffentlich bis April ihren Abschluss .
Only thing missing ... the text of your choice !	Das Einzige , was fehlt ... den Text Ihrer Wahl !
But when does competition arise ?	Wann aber gibt es erst Wettbewerb ?
That is unacceptable .	Das ist nicht hinnehmbar .
That concludes the explanations of vote .	Damit sind die Erklärungen zur Abstimmung beendet .
Still here and working like troopers !	The B ##AT##-##AT## Sides Available For FREE for a Limited Time !
Written on : May 31st , 2008 in Deserts .	Verfasst am : May 31st , 2008 in Deserts .
( Applause )	( Beifall )
Our company is provided with a very good workshop equipment .	Unsere Firma ist mit hochwertigen Maschinen ausgestattet .
2010 Austria Philharmonic 100 Euro / 1 ##AT##-##AT## OZ .	2010 Österreich Philharmoniker 100 Euro / 1 ##AT##-##AT## OZ .
We shall now proceed to the vote .	Wir kommen zur Abstimmung .
A debt crisis is not inevitable .	Eine Schuldenkrise ist nicht unausweichlich .
In some cases you may not want that .	In einigen Fällen ist das nicht angebracht .
How can I make a call with Voipax instant ?	Wie kann ich mit Voipax instant anrufen ?
This seems to me very strange .	Das ist merkwürdig .
Where is your contribution to a meaningful debate ?	Wo ist denn Ihr Beitrag zu einer sinnvollen Diskussion ?
Looking and seeing are different from one another .	Olhar e ver são diversos entre si .
For further information click on the title .	Für weitere Informationen den Filmtitel anklicken .
Thank you for supporting our record attempt .	Vielen Dank , dass Sie unseren Rekordversuch unterstützen !
( The sitting was closed at 11.15 p.m. )	( Die Sitzung wird um 23.15 Uhr geschlossen . )
( The oral amendment was accepted )	( Der mündliche Änderungsantrag wird angenommen . )
That is the first thing .	Das war meine erste Anmerkung .
Click on the Continue button to start the registration ...	Klicken Sie auf Weiter , um mit der Anmeldung zu beginnen ...
In practice this option is already open to operators .	In der Praxis steht diese Option den Herstellern bereits offen .
On paragraph 9	Zu Ziffer 9
Hu is due to remain in power until 2012 .	Hu soll bis 2012 an der Macht bleiben .
Team members are from our company .	Die Teammitglieder sind Mitarbeiter unserer Firma .
Well , the legal problems are considerable .	Es bestehen also ganz erhebliche rechtliche Schwierigkeiten .
This is what this is about .	Darum geht es .
That was my comment .	Soweit meine Bemerkung .
Please send a short email notice .	&quot; , sagte Stefan Pantke , Geschäftsführer von turingart &#91; CUBiC GmbH &#93; .
It is in the center of the city .	The only positive was the location .
What do I mean ?	Worauf will ich hinaus ?
What about an aircraft carrier ?	Wie wäre es mit einem Flugzeugträger ?
Here I must cite Article 128 .	Hier ist es Artikel 128 , den ich zitieren muß .
A TV can be provided in your room upon request .	Auf Anfrage wird Ihr Zimmer mit einem Fernsehgerät versehen .
Independent and individual - just like you !	Unabhängig und einzigartig – genau wie Sie !
Your press release will be read more often .	Ihr Artikel wird dann erheblich öfter gelesen .
Thank you for your attention .	Danke für Ihre Aufmerksamkeit .
A world first goes into operation .	Eine Weltneuheit nimmt ihre Arbeit auf .
Was all this really to be imposed uniformly right across Europe ?	Und all das europäisch einheitlich vorgeschrieben ?
Behind every game there are first and foremost the people who made it .	Hinter jedem Spiel stecken vor allem Menschen .
So we need to go on working on this directive .	Deshalb ist es notwendig , daß wir weiter an dieser Richtlinie arbeiten .
Conil Hotel Conil Hotels in Conil - How to get there ?	Conil Hotel Conil Hotels in Conil - Wie Komme Ich hin ?
I shall move on now to the socio ##AT##-##AT## economic considerations .	Nun zu den sozioökonomischen Erwägungen .
3 . South Korea - death penalty declared legal (	3. Südkorea - Todesstrafe für legal erklärt (
Thank you , Mr Galeote Quecedo .	Ich danke Ihnen , Herr Galeote Quecedo .
Do all relevant employees know what to do when ?	Sind alle Ressourcen und Kosten jedem Teil des Projektes geplant ?
Hotel in Fuengirola , of new construction in excellent location .	Neues Hotel in Fuengirola , sehr gute Lage .
Therefore , we cannot support this proposal .	Daher können wir diesen Vorschlag nicht unterstützen .
Noonan is not quite correct .	Noonan hat nicht ganz Recht .
The room was very big and spacious .	Sehr gut zentral gelegen und trotzdem sehr ruhig . Grosse Zimmer .
Towels and table cloths are not included .	Hand und Tischtücher sind nicht gestellt .
Lanzarote is an island that invites you to discover her .	Lanzarote ist eine Insel die dazu einlädt , sie zu entdecken .
But not because of alcohol and drugs ( amf ) !	Aber nicht , weil der Alkohol und Drogen ( AMF ) !
Lukashenko will run for the third time in these elections .	Lukaschenko tritt bei diesen Wahlen zum dritten Mal an .
It merely postpones a solution .	Es schiebt die Lösung nur auf die lange Bank .
Of that I am all in favour .	Diese sollten wir respektieren . Dafür trete ich ein .
by Ralf Dahrendorf	von Ralf Dahrendorf
You will recieve a prompt reply .	Wir werden Ihnen eine Antwort prompt zukommen lassen .
They have been living under a dictatorship .	Sie leben in einer Diktatur .
Home users however can just disable it .	Heimanwender können ihn meist jedoch getrost deaktivieren .
; Check in from 14H00 - Check out by 12H00 .	; Check in ab 14 Uhr - Check out bis 12 Uhr .
The vote will take place tomorrow .	Die Abstimmung findet morgen statt .
The call is specified by a compatible compiler pragma .	Der Aufruf wird durch ein kompatibles Compilerpragma gesteuert .
But now you have crossed the Rubicon .	Sie haben jetzt Nägel mit Köpfen gemacht .
That concludes Question Time .	Damit ist die Fragestunde beendet .
A flag has four corners and theirs has three available .	Eine Flagge hat vier Ecken , und an ihrer sind drei verfügbar .
How many applications are unfounded ?	Wie viele Asylanträge sind unbegründet ?
The first is Kosovo .	Erstens : Kosovo .
You can delete this data at any time .	Diese Daten können Sie jederzeit wieder löschen .
What advantages does Endoscopy has to offer ?	Welche Vorteile bietet die Endoskopie an ?
You are here because you look for profitable business .	Sie sind hier , da Sie nach einem profitablen Geschäft suchen .
Finally on the last observation , I agree with her .	Schließlich auf die letzte Bemerkung , ich stimme mit ihr .
Our Online Shop is open 24 / 7 for your orders !	Unser Shop hat 24 Stunden am Tag für Ihre Bestellungen geöffnet !
There was no fraud or violence .	Es kam weder zu Betrug noch Gewalt .
Teknotrans translates to and from most languages .	Teknotrans übersetzt in und aus den meisten größeren Sprachen .
You are right about this .	Hierin gebe ich ihm Recht .
It should remain European .	Es soll europäisch bleiben .
That is actually just as bad .	Praktisch ist es genauso schlimm .
A little bit everywhere ?	Überall ein bisschen ?
Coordination of the IT strategy of the company .	Koordination der technischen Ausrichtung des Unternehmens .
Thank you , Minister .	Vielen Dank , Herr Minister .
The Ministry of Agriculture Office on New Year &apos;s D ...	Ministerium für Landwirtschaft Amt für Neujahr u ...
As is so often the case , the devil lies in the detail .	Der Teufel liegt ­ wie so oft ­ auch hier im Detail .
I declare the session of the European Parliament adjourned .	Je déclare interrompue la session du Parlement européen .
No other orchestra focuses on this repertoire .	Kein anderes Ensemble widmet sich ganz und gar diesem Repertoire .
..... 20 minutes by walk and 10 minutes by metro .	..... 20 Minuten zu Fuss und 10 Minuten mit der Untergrundbahn .
The temperature of your toes can go down to 8 degrees !	Bis auf 8 Grad kann die Temperatur in den Zehen sinken !
I think that is a regrettable situation .	Das halte ich für bedauerlich .
Why not ?	Warum nicht ?
SQL Server 2008 gains steam - we fuel it !	SQL Server 2008 erfreut sich zunehmender Beliebtheit .
I cannot read it .	Ich kann sie nicht lesen .
A controller can process up to 2,000 access groups .	Ein Controller kann bis 2.000 Zugangsgruppen bearbeiten .
Smoking is allowed on the balcony .	Wir freuen uns , Ihnen im ganzen Haus gute Valser Bergluft anbieten zu können .
Pro Info Design of Ana Ivanovic and use Drupal !	Pro Info Design von Ana Ivanovic und die Verwendung Drupal !
In the fight against terrorism we need to keep them close .	Bei der Bekämpfung des Terrorismus brauchen wir ihre Nähe .
There are serious defects in the Commission &apos;s proposal .	Er enthält jedoch auch schwerwiegende Mängel .
I will mention a few examples .	Ich nenne Ihnen einige Beispiele .
The debate is closed .	Die Aussprache ist geschlossen .
The reform is in fact important for Parliament .	Die Reform ist in der Tat wichtig für das Parlament .
The contribution of others will also be welcome .	Die Beiträge anderer werden ebenso willkommen sein .
President of the Italian Association of Sport Psychology .	Präsident des Italienischen Vereins Sportpsychologie .
As you change the community in the era of Social Media ?	Wie Sie die Gemeinschaft im Zeitalter der Social Media ?
For students with a good command of the German language .	Sie haben schon sehr gute Kenntnisse der deutschen Sprache .
Simply because most of them want it that way .	Aus dem einfachen Grund , dass es die meisten von ihnen so wollen .
CC121 will be available from Q3 2008 .	Der CC121 wird im 3. Quartal 2008 verfügbar sein .
George Stobbart - occupation : American tourist in Paris .	George Stobbart - Beruf : Amerikanischer Tourist in Paris .
There are two issues I would like to draw your attention to .	Nun möchte ich Ihre Aufmerksamkeit auf zwei Dinge lenken .
To decompress the files you &apos;ll need a ZIP software .	Sie benötigen zum Entpacken ein ZIP ##AT##-##AT## Programm .
The compromise suggests 15 June 2015 .	Das Kompromissdatum ist der 15. Juni 2015 .
We are not entirely clear about these social situations .	Wir können die sozialen Gegebenheiten nicht exakt einschätzen .
I voted in favour of this report .	Ich habe für diesen Bericht gestimmt .
The vote will take place tomorrow at 12 noon .	Die Abstimmung findet morgen um 12.00 Uhr statt .
It is the EU that must take this task upon itself .	Diese Aufgabe muss die EU übernehmen .
126 installations scrobbled by UpdateStar last month .	63 Mal gescrobbelt von UpdateStar im letzten Monat .
The right partner for your objectives .	Der richtige Partner für Ihre Ziele .
Parliament wants to go further .	Das Parlament möchte noch weiter gehen .
Table tennis is also an option .	Auch eine Partie Tischtennis ist möglich .
Should sexual contacts not be ...	Sollten sexuelle Kontakte nicht ...
Please fill in the form below .	Füllen Sie dazu bitte die unteren Felder aus .
You cannot build it in a different directory .	Sie können es nicht in einem anderen Verzeichnis erstellen .
I shall refrain from mentioning all of these .	Ich möchte sie aber jetzt nicht alle aufzählen .
We shall therefore repeat the vote .	Deswegen wiederholen wir die Abstimmung .
The Commission is helping in this .	Hier leistet die Kommission einen wichtigen Beitrag .
The staff were pleasand and helpful .	Die Freundlichkeit und Hilfsbereitschaft des Personals .
Be polite and do not go off ##AT##-##AT## topic .	Seien Sie höflich und gehen nicht off ##AT##-##AT## topic .
Trolls are destroyed by daylight .	In der Sonne verschwinden die Schatten .
Energy Policy	Energiepolitik
Timezones : What time is it in Cook Islands ?	Zeit Zonen : Welche Zeit ist es in Cook Islands ?
The breakfast was very good and had a wide selection .	Die Innenstadt ist einfach zu erreichen .
That must be dealt with .	Das muss geklärt werden .
There are a great many reasons why this is the case .	Hierfür gibt es zahlreiche Gründe .
So let us put an end to this nonsense as quickly as possible !	Daher so rasch wie möglich Schluß mit diesem Unfug !
Parliament is aware of the statement .	Die Erklärung ist dem Parlament bekannt .
This can happen very quickly .	Das kann sehr rasch geschehen .
Thank you very much , Commissioner Patten .	Vielen Dank , Herr Kommissar Patten .
At what age is it safe for a newborn baby to fly ?	Ab wann darf man mit einem Säugling fliegen ?
&#91; ... &#93; 900 000 EUR for a domain name .	&#91; ... &#93; 900 000 EUR für einen Domain ##AT##-##AT## Namen .
It really is not good enough .	Dies ist wirklich nicht genug .
( The sitting was closed at 7.59 p.m. )	( Die Sitzung wird um 19.59 Uhr geschlossen . )
For reservation visit our page of last minute .	Wir hoffen sie bald als gast bei uns begruessen zu duerfen .
We should , of course , not get overly excited about it .	Natürlich dürfen wir uns davon nicht allzuviel versprechen .
Ccwa had only one son called Kalemeera .	Ccwa hatte nur einen Sohn namens Kalemeera .
And in the morning we were rehearsing the upcoming concert .	Zwei neue klasse Lieder sind entstanden .
I believe that it is important to give you a few figures .	Ich glaube , es ist wichtig , hier einige Zahlen zu nennen .
The terrace belong to room number 5 .	Ca &apos; Leon D &apos; Oro ist in venezianischen Stil des 18.
In which language do you want to translate the keyword ?	In welcher Sprache ist Deine Übersetzung ?
We see a whole collection of new listings .	Es wurde eine Menge neuer Übersichten erstellt .
Included in planning right from the start .	Von Beginn an in der Planung berücksichtigt .
However , 22 966 children do have a parent .	Allerdings haben davon 22 966 einen Vater oder eine Mutter .
Question : Can I leave the children alone ?	Frage : Kann ich die Kinder alleine lassen ?
You can subscribe to the mailing list here .	Hier können Sie sich für das Newsletter anmelden .
( Parliament adopted the resolution )	( Das Parlament nimmt den Entschließungsantrag an . )
We do not hunt down criminals . That is OLAF &apos; s job .	Wir jagen aber keine Verbrecher - dafür ist OLAF zuständig .
Off The Rails Navigate your handcar safely .	Off The Rails Fahre deinen Handwagen sicher durch die Level .
We shall quickly have to change this situation .	Wir müssen schnell einen anderen Weg einschlagen .
Current news from the education section .	Aktuelle Nachrichten aus dem Bereich Bildung .
Firstly small companies are of divergent types .	Erstens sind die Kleinunternehmen sehr unterschiedlich .
These are long ##AT##-##AT## term tasks .	Dies sind langfristige Aufgaben .
It sounds terrific – and on a superb organ .	Ein Aufbau , der einen vom Stuhl reißt . Wirklich : Gratulation !
We see ourselves as on the same side as you .	Denn unserer Meinung nach stehen wir auf derselben Seite .
Description : We know what you are looking for .	Beschreibung : We know what you are looking for .
I see no reason why these should be abolished .	Ich sehe keinen Grund , warum sie abgeschafft werden sollten .
The final text is very clear on this matter .	Der endgültige Wortlaut is da sehr eindeutig .
The price for an extra bed is 500 , - CZK all year .	Preis für Zusatzbett ist ganz jährig 500 , - CZK .
Therefore , I welcome Pastor Tőkés to the Bureau .	Demnach heiße ich Pastor Tőkés im Präsidium willkommen .
We have not used the word &apos; veto &apos; .	Wir haben es nicht Veto genannt .
Our specialists can also assist you with your maintenance .	Wartung wird bei Imtech DryGenic groß geschrieben .
For us the report is a disappointment .	Wir finden den Bericht enttäuschend .
In many cases , time has already run out .	Es ist an vielen Stellen schon 1 Sekunde nach 12 !
Do global summits still have a role ?	Haben internationale Gipfeltreffen noch eine Funktion ?
This is the only solution that is correct .	Das ist die einzige mögliche und korrekte Lösung .
The staff were friendly and helpful .	Delightful kind on mountains and Ionian sea .
Europe needs to be more active and more united .	Europa muss aktiver und geschlossener vorgehen .
Regrettably , Mr Pimenta cannot be here .	Leider kann Herr Pimenta nicht anwesend sein .
Murahera was near the churches of St. Anne and St. Nicholas .	Murahera war nah an den Kirchen St. Anna und St. Nikolaus .
Gordon was played by Joseph Fuqua .	Paul Gordon wurde von Joseph Fuqua gespielt .
Should we do more ?	Sollten wir mehr tun ?
Words are powerless .	Bloße Worte sind nutzlos .
That is fine by me .	Damit bin ich einverstanden .
It was ok for one night stop .	Das Hotel liegt in der Nähe des Zentrums , leider an einer Kreuzung .
Linux Guide for beginners with netbooks .	Linux Guide für Anfänger mit Netbooks .
Change your name on your MySpace into an image !	Ändern Sie Ihren Namen auf Ihrem MySpace in ein Bild !
If it is included in the price it will say so on the website .	Wenn es inbegriffen ist , wird dies angegeben .
Teal Dawn owns a dire Polar Bear named Pike .	Teal Dawn besitzt einen furcht erregenden Eisbären mit dem Namen Pike .
But LiveZilla Server Admin can do more for you .	Aber der LiveZilla Server ##AT##-##AT## Admin kann noch mehr .
I want to call that into question .	Ich möchte das in Frage stellen .
It is not quite over yet .	Und dies ist noch nicht ganz abgeschlossen .
It is the thing that goes bump in the night .	Manche merken zu spät , dass tatsächlich Monster unterm Bett leben .
JoSTrans , has been created with these features in mind .	JoSTrans wurde im Hinblick auf diese Faktoren entwickelt .
There is no agreement on anything else .	Es gibt keine weiteren Abmachungen .
Does SYNCING.NET work with older Outlook versions ( 97 / 98 ) or Outlook Express ?	Wie häufig gibt es neue Versionen ?
We must win over national public opinion .	Wir müssen die Öffentlichkeit in den Einzelstaaten für unsere Sache gewinnen .
The vote will take place at 6.30 p.m.	Die Abstimmung findet um 18.30 Uhr statt .
The vote will take place tomorrow at 12 noon .	Die Abstimmung findet morgen um 12.00 Uhr statt .
He especially enjoys driving his new Renault Megane .	Besonders gefällt ihm das Fahren seines neuen Renault Megane .
I do not propose to go into further detail about this .	Ich will das gar nicht weiter vertiefen .
All offers and prices are non ##AT##-##AT## binding .	Alle Angebote und Preise sind freibleibend und unverbindlich .
House for sale in Reus ( Tarragona ) Terraced - Ref .	Haus zum verkauf in Reus ( Tarragona ) Reihen - Ref .
I know we will first have to wait for the exact mandate here .	Ich weiß , da müssen wir erst das genaue Mandat abwarten .
It cannot be simply delivered on a plate , ready ##AT##-##AT## made .	Sie darf nicht einfach im Raum stehen und fertig .
Thank you , Mr Söderman .	Danke , Herr Söderman .
The vote will take place after the debates .	Die Abstimmung erfolgt am Ende der Aussprachen .
admin : hab aber vergessen zu fügen hinzu das a .	Admin : hab aber vergessen zu hinzu Fügen das a.
Part one	Erster Teil
Use of the minibar is free of charge .	Die Getränke in der Minibar stehen Ihnen kostenfrei zur Verfügung .
Or you can follow us via ..	Oder Sie können uns folgen über ..
Peru	Peru
Macedonia is a state .	Mazedonien ist ein Staat .
Increasingly , nuclear energy is being replaced by gas .	Die Nuklearenergie wird zunehmend durch Gas ersetzt .
I think a lot of it , I really do .	Und ich halte viel davon , sehr , sehr viel .
A superb crab from the famous site of Solnhofen .	Ein Borstenwurm aus dem Plattenkalk . Eine besondere Rarität .
I submit the remaining text to the vote .	Ich lasse daher zunächst über den Rest des Absatzes abstimmen .
Unfortunately , nothing has changed in that regard .	Daran hat sich leider nichts geändert .
That makes sense .	Das macht Sinn .
The death penalty is irrevocable .	Die Todesstrafe ist unwiderruflich .
closes any open cursor before opening a new one .	einen eventuell noch offenen Cursor , ehe es einen neuen öffnet .
Here I shall comment on two aspects in particular .	Hier halte ich besonders zwei Aspekte für wichtig .
( Applause )	( Applaus )
We now move to questions to Mr Füle .	Wir kommen jetzt zu den Fragen an Herrn Füle .
( Loud applause )	( Lebhafter Beifall )
The analysis is under way .	Eine entsprechende Analyse wird derzeit erarbeitet .
What specifically will it change , and what does it aim to change ?	Was ändert er konkret , und was möchte er ändern ?
By default this is empty because it is really slow .	Standardmäßig leer , da es sehr langsam ist .
Skiareál Rokytnice nad Jizerou – Spartak Rokytnice a.s.	Skigebiet Rokytnice nad Jizerou – Spartak Rokytnice a.s.
Enter your iPhone meets Windows username .	Geben Sie Ihren iPhone trifft Windows ##AT##-##AT## Benutzernamen ein .
Thank you Mrs Aelvoet .	Danke schön , Frau Aelvoet .
The social model is profoundly discriminatory .	Das Sozialmodell ist zutiefst diskriminierend .
Not every partner accepts exactly the same wording .	Nicht jeder Partner akzeptiert genau die gleiche Formulierung .
And a critical opportunity is before us .	Momentan bietet sich uns eine entscheidende Chance .
What would the citizens do ?	Was würden die Bürgerinnen und Bürger tun ?
Placing the implant is a 5 min operation .	Das Einsetzen des Implantates ist ein Verfahren , das nur 5 Min .
It is not handed out by a giant tooth fairy .	Es wird nicht von einer riesigen Zahnfee verteilt .
They will all be necessary .	Alle werden gebraucht .
An excellent option for a party of up to 5 people .	Eine tolle Unterkunft für eine kleine Gruppe von bis zu 5 Personen .
Nevertheless , we have taken action .	Trotz allem sind wir tätig geworden .
That is not a perspective that I share .	Diese Auffassung teile ich nicht .
Register today and see for yourself !	Meld dich bei uns , es lohnt sich !
Criticism only works when it belongs to a collective .	Kritik funktioniert nur als Teil eines Kollektivs .
Cleverlearn Privacy Notice and Information Practice .	Cleverlearn Datenschutzerklärung und Umgang mit Informationen .
We should not mistake this for a war .	Wir sollten hier nicht irrtümlich von einem Krieg sprechen .
Perhaps it is worth mentioning some of the subjects .	Vielleicht lohnt es , einige der Themen zu nennen .
And Nephi did minister with a power and with great authority .	Und Nephi diente mit a Macht und mit großer Vollmacht .
We have set ourselves a task .	Wir haben uns selbst eine Aufgabe gegeben .
On this point , I appeal for a bit more of a sense of reality .	Da appelliere einen bisschen mehr an den Realitätssinn .
Commission .	Frau Abgeordnete !
Grant asked for ideas in BIOS flashing .	Grant fragt nach Ideen , wie man ein BIOS flashen kann .
Your models thus become abstractions of the program code .	Ihre Modelle werden damit zur Abstraktion des Programmcodes .
A number of amendments have already been discussed .	Einige Änderungsanträge wurden jetzt schon diskutiert .
Staff were very helpful and breakfast was excellent .	Safe war im Zimmer vorhanden und kostenlos .
People flooded the doors , desperate for a warm meal .	People flooded the doors in droves , desperate for a warm meal .
The second issue concerns the distance bands .	Das zweite Problem betrifft die Entfernungskategorien .
Neglect in the Middle East is rarely benign .	Eine Vernachlässigung des Nahen Ostens ist selten zuträglich .
Nor will that happen , however .	Das wird nun nicht geschehen .
20 % casino bonus keshbek - up to $ 100 .	20 % Casino Bonus keshbek - bis zu 100 $ .
rapporteur . - ( DE ) Mr President , you despot !	Berichterstatter . - Herr Willkürpräsident !
Anodized dull black for good view of specimens .	Gute Beobachtung der Präparate durch mattschwarze Oberfläche .
The safety standards authority to guest with Cult Society !	Der TÜV Süd zu Gast bei Cult Society !
That is not so easy to do in practice .	Das ist in der Praxis nicht einfach .
Let me speak anecdotally .	Ich will Ihnen mit einer Anekdote antworten .
We must fight against the others as well .	Die übrigen Stoffe müssen ebenfalls bekämpft werden .
Listed below are the downloads that match your search .	Unten sehen Sie alle Ihrer Suche entsprechenden Downloads .
The Volume 5 will be released on September 1st 2010 !	Die Band 5 wird 2010 erster freigegeben werden auf September !
But many among the public and in the media want more .	Doch wollen viele in der Öffentlichkeit und den Medien mehr .
The weight is not on war and peace .	Das Gewicht wird nicht über Krieg und Frieden .
We did not in fact support all the amendments .	Wir haben nicht allen Änderungsanträgen zugestimmt .
Your ad will run for one year .	Ihre Anzeige geschaltet werden soll für eine Dauer d \ &apos; ein Jahr .
Keeping our collection current is a priority .	Unsere Sammlung aktuell zu halten , ist uns ein Hauptanliegen .
Get notified when dila21 adds new stuff .	Werde benachrichtigt wenn dila21 neue Slideshows erstellt .
Therefore , we must take action now .	Deswegen müssen wir jetzt handeln !
What is more , we shall do this in a transparent fashion .	Wir werden dies in transparenter Weise tun .
How will patient records be exchanged ?	Wie erfolgt der Austausch der Patientenakten ?
It was in easy reach of the city centre .	good sized room and good facilities.Room was not noisy at night .
You will have by your ...	Das Hotel ist vom Zentrum durch die Metro ...
This will be true for only a small proportion of images .	Dies trifft jedoch nur auf einen geringen Anteil Bilder zu .
Recommendations are surfing tips from and for other users .	Empfehlungen sind Surfhinweise von und für andere Nutzer .
But , as I say , that is a cynical comment .	Wie ich jedoch sagte , ist dies eine zynische Bemerkung .
I myself have come up with three ideas .	Ich persönlich habe seinerzeit drei Vorstellungen formuliert .
The Commission has no choice but to oppose these .	Von der Kommission muß entsprechend reagiert werden .
Why am I mentioning this ?	Warum sage ich das ?
On IFFA 2007 Seydelmann presented lots of innovations .	Zur IFFA 2007 präsentiert Seydelmann viele neue Innovationen .
6 . Agreements on trade in bananas	6. Abkommen über den Bananenhandel
Let your skills bring in the fortune !	Forder Sie mit Ihrem K � nnen das Gl � ck heraus !
Reception is only the first stage .	Die Aufnahme ist jedoch nur eine Etappe .
( The President cut off the speaker )	( Die Präsidentin entzieht der Rednerin das Wort . )
It can create uniform authorisation procedures ,	Zulassungsverfahren
Personally , I feel very strongly that there is a need for this .	Mir persönlich liegt sehr viel daran .
That is what I can tell you .	Das ist es , was ich Ihnen mitzuteilen habe .
Let me turn to the issue of migration .	Ich möchte jetzt etwas zum Thema Migration sagen .
Firstly , the question of the Commission .	Zunächst die Frage der Kommission .
Outdoor fire place and grill are available .	Zur Verfügung stehen auch eine offene Feuerstelle und ein Außengrill .
It is needed today more than ever .	Sie ist heute erforderlicher als je zuvor .
Commissioner Poul Nielson has not yet been to Chechnya .	Kommissar Poul Nielson war immer noch nicht in Tschetschenien .
In most cases the error is one line above .	In den meisten Fällen befindet sich der Fehler direkt eine Zeile davor .
All of this needs to be done fast , by September 18 th .	Das hat allerdings rasch , bis 18. September , zu geschehen .
But it isn ’ t at all a utopia .	Ich habe alles ein bisschen mitgemacht , was es so gibt .
You set the date using the left half of the module .	Das Datum wird im linken Teil des Moduls eingestellt .
There &apos;s a bunch of stuff about our brands here .	Sie finden hier zahlreiche Informationen zu unseren Marken .
What technical conference equipment will you need for your event ?	Welche Konferenztechnik benötigen Sie für Ihr Event ?
Thank you very much , Commissioner .	Vielen Dank , Frau Kommissarin .
6 A simple layout for your comments !	5 Ein einfaches Layout für Ihre Kommentare !
An apocalyptic scenario in the making ?	Braut sich ein apokalyptisches Szenarium zusammen ?
Is there a limit to the size of the file I can send ?	Warum ist an der Seite meines Briefs ein Barcode aufgedruckt ?
Service is our success .	Service is our success .
An official collector product does not exist with that coin .	Es gibt dazu keine offizielle Sammlerausgabe .
Ireland is an island that is situated at the edge of Europe .	Irland ist eine Insel am Rande Europas .
